cod_ibge;tiposeade;estadual;federal;municipal;particular;total_geral
3500105;Clínica;0;0;6;20;26
3500105;Consultório Isolado;0;0;6;148;154
3500105;Diagnose e Terapia;0;0;1;16;17
3500105;Hospital;0;0;0;2;2
3500105;Outros;0;0;3;1;4
3500105;Pronto Atendimento;0;0;0;0;0
3500105;Unidade Básica de Saúde;0;0;9;0;9
3500105;Unidade de Saúde Mental ;0;0;1;0;1
3500105;Unidade Móvel;1;0;1;0;2
3500105;Vigilância em Saúde;0;0;4;0;4
3500204;Clínica;0;0;1;0;1
3500204;Consultório Isolado;0;0;0;2;2
3500204;Diagnose e Terapia;0;0;0;1;1
3500204;Hospital;0;0;0;0;0
3500204;Outros;0;0;1;0;1
3500204;Pronto Atendimento;0;0;0;0;0
3500204;Unidade Básica de Saúde;0;0;1;0;1
3500204;Unidade de Saúde Mental ;0;0;0;0;0
3500204;Unidade Móvel;0;0;0;0;0
3500204;Vigilância em Saúde;0;0;0;0;0
3500303;Clínica;0;0;2;3;5
3500303;Consultório Isolado;0;0;0;56;56
3500303;Diagnose e Terapia;0;0;1;7;8
3500303;Hospital;0;0;0;1;1
3500303;Outros;0;0;2;4;6
3500303;Pronto Atendimento;0;0;1;0;1
3500303;Unidade Básica de Saúde;0;0;5;0;5
3500303;Unidade de Saúde Mental ;0;0;1;0;1
3500303;Unidade Móvel;0;0;1;0;1
3500303;Vigilância em Saúde;0;0;2;0;2
3500402;Clínica;0;0;0;3;3
3500402;Consultório Isolado;0;0;0;4;4
3500402;Diagnose e Terapia;0;0;0;0;0
3500402;Hospital;0;0;0;0;0
3500402;Outros;0;0;1;0;1
3500402;Pronto Atendimento;0;0;0;0;0
3500402;Unidade Básica de Saúde;0;0;3;0;3
3500402;Unidade de Saúde Mental ;0;0;0;0;0
3500402;Unidade Móvel;0;0;0;0;0
3500402;Vigilância em Saúde;0;0;0;0;0
3500501;Clínica;0;0;2;9;11
3500501;Consultório Isolado;0;0;0;30;30
3500501;Diagnose e Terapia;0;0;0;6;6
3500501;Hospital;0;0;0;1;1
3500501;Outros;0;0;1;0;1
3500501;Pronto Atendimento;0;0;0;0;0
3500501;Unidade Básica de Saúde;0;0;7;0;7
3500501;Unidade de Saúde Mental ;0;0;1;0;1
3500501;Unidade Móvel;0;0;0;0;0
3500501;Vigilância em Saúde;0;0;1;0;1
3500550;Clínica;0;0;0;2;2
3500550;Consultório Isolado;0;0;0;6;6
3500550;Diagnose e Terapia;0;0;0;0;0
3500550;Hospital;0;0;0;0;0
3500550;Outros;0;0;1;0;1
3500550;Pronto Atendimento;0;0;0;0;0
3500550;Unidade Básica de Saúde;0;0;4;0;4
3500550;Unidade de Saúde Mental ;0;0;0;0;0
3500550;Unidade Móvel;0;0;0;0;0
3500550;Vigilância em Saúde;0;0;0;0;0
3500600;Clínica;0;0;1;0;1
3500600;Consultório Isolado;0;0;0;2;2
3500600;Diagnose e Terapia;0;0;0;2;2
3500600;Hospital;0;0;0;0;0
3500600;Outros;0;0;2;0;2
3500600;Pronto Atendimento;0;0;1;0;1
3500600;Unidade Básica de Saúde;0;0;1;0;1
3500600;Unidade de Saúde Mental ;0;0;0;0;0
3500600;Unidade Móvel;0;0;0;0;0
3500600;Vigilância em Saúde;0;0;0;0;0
3500709;Clínica;0;0;0;5;5
3500709;Consultório Isolado;0;0;0;34;34
3500709;Diagnose e Terapia;0;0;0;2;2
3500709;Hospital;0;0;0;1;1
3500709;Outros;0;0;1;0;1
3500709;Pronto Atendimento;0;0;1;0;1
3500709;Unidade Básica de Saúde;0;0;11;0;11
3500709;Unidade de Saúde Mental ;0;0;1;0;1
3500709;Unidade Móvel;0;0;1;0;1
3500709;Vigilância em Saúde;0;0;0;0;0
3500758;Clínica;0;0;0;0;0
3500758;Consultório Isolado;0;0;0;1;1
3500758;Diagnose e Terapia;0;0;0;1;1
3500758;Hospital;0;0;0;0;0
3500758;Outros;0;0;2;0;2
3500758;Pronto Atendimento;0;0;0;0;0
3500758;Unidade Básica de Saúde;0;0;5;0;5
3500758;Unidade de Saúde Mental ;0;0;0;0;0
3500758;Unidade Móvel;0;0;1;0;1
3500758;Vigilância em Saúde;0;0;0;0;0
3500808;Clínica;0;0;0;0;0
3500808;Consultório Isolado;0;0;0;1;1
3500808;Diagnose e Terapia;0;0;0;0;0
3500808;Hospital;0;0;0;0;0
3500808;Outros;0;0;1;0;1
3500808;Pronto Atendimento;0;0;0;0;0
3500808;Unidade Básica de Saúde;0;0;1;0;1
3500808;Unidade de Saúde Mental ;0;0;0;0;0
3500808;Unidade Móvel;0;0;0;0;0
3500808;Vigilância em Saúde;0;0;0;0;0
3500907;Clínica;0;0;1;0;1
3500907;Consultório Isolado;0;0;0;3;3
3500907;Diagnose e Terapia;0;0;0;0;0
3500907;Hospital;0;0;0;0;0
3500907;Outros;0;0;2;0;2
3500907;Pronto Atendimento;0;0;0;0;0
3500907;Unidade Básica de Saúde;0;0;3;0;3
3500907;Unidade de Saúde Mental ;0;0;0;0;0
3500907;Unidade Móvel;0;0;1;0;1
3500907;Vigilância em Saúde;0;0;0;0;0
3501004;Clínica;0;0;5;6;11
3501004;Consultório Isolado;0;0;2;32;34
3501004;Diagnose e Terapia;0;0;1;0;1
3501004;Hospital;0;0;0;1;1
3501004;Outros;0;0;3;0;3
3501004;Pronto Atendimento;0;0;0;0;0
3501004;Unidade Básica de Saúde;0;0;7;0;7
3501004;Unidade de Saúde Mental ;0;0;0;0;0
3501004;Unidade Móvel;0;0;1;0;1
3501004;Vigilância em Saúde;0;0;2;0;2
3501103;Clínica;0;0;1;0;1
3501103;Consultório Isolado;0;0;0;2;2
3501103;Diagnose e Terapia;0;0;0;0;0
3501103;Hospital;0;0;1;0;1
3501103;Outros;0;0;1;0;1
3501103;Pronto Atendimento;0;0;0;0;0
3501103;Unidade Básica de Saúde;0;0;3;0;3
3501103;Unidade de Saúde Mental ;0;0;0;0;0
3501103;Unidade Móvel;0;0;0;0;0
3501103;Vigilância em Saúde;0;0;0;0;0
3501152;Clínica;0;0;1;4;5
3501152;Consultório Isolado;0;0;1;4;5
3501152;Diagnose e Terapia;0;0;0;1;1
3501152;Hospital;0;0;0;0;0
3501152;Outros;0;0;2;0;2
3501152;Pronto Atendimento;0;0;1;0;1
3501152;Unidade Básica de Saúde;0;0;2;0;2
3501152;Unidade de Saúde Mental ;0;0;0;0;0
3501152;Unidade Móvel;0;0;0;0;0
3501152;Vigilância em Saúde;0;0;2;0;2
3501202;Clínica;0;0;0;0;0
3501202;Consultório Isolado;0;0;0;1;1
3501202;Diagnose e Terapia;0;0;0;0;0
3501202;Hospital;0;0;0;0;0
3501202;Outros;0;0;1;0;1
3501202;Pronto Atendimento;0;0;0;0;0
3501202;Unidade Básica de Saúde;0;0;3;0;3
3501202;Unidade de Saúde Mental ;0;0;0;0;0
3501202;Unidade Móvel;0;0;0;0;0
3501202;Vigilância em Saúde;0;0;0;0;0
3501301;Clínica;0;0;2;3;5
3501301;Consultório Isolado;0;0;0;11;11
3501301;Diagnose e Terapia;0;0;0;4;4
3501301;Hospital;0;0;0;1;1
3501301;Outros;0;0;2;0;2
3501301;Pronto Atendimento;0;0;0;0;0
3501301;Unidade Básica de Saúde;0;0;8;0;8
3501301;Unidade de Saúde Mental ;0;0;0;0;0
3501301;Unidade Móvel;0;0;0;0;0
3501301;Vigilância em Saúde;0;0;0;0;0
3501400;Clínica;0;0;0;0;0
3501400;Consultório Isolado;0;0;0;0;0
3501400;Diagnose e Terapia;0;0;0;0;0
3501400;Hospital;0;0;0;0;0
3501400;Outros;0;0;1;0;1
3501400;Pronto Atendimento;0;0;0;0;0
3501400;Unidade Básica de Saúde;1;0;1;0;2
3501400;Unidade de Saúde Mental ;0;0;0;0;0
3501400;Unidade Móvel;0;0;0;0;0
3501400;Vigilância em Saúde;0;0;0;0;0
3501509;Clínica;0;0;0;0;0
3501509;Consultório Isolado;0;0;0;0;0
3501509;Diagnose e Terapia;0;0;0;0;0
3501509;Hospital;0;0;0;0;0
3501509;Outros;0;0;2;0;2
3501509;Pronto Atendimento;0;0;0;0;0
3501509;Unidade Básica de Saúde;0;0;1;0;1
3501509;Unidade de Saúde Mental ;0;0;0;0;0
3501509;Unidade Móvel;0;0;0;0;0
3501509;Vigilância em Saúde;0;0;0;0;0
3501608;Clínica;0;0;5;27;32
3501608;Consultório Isolado;0;0;1;942;943
3501608;Diagnose e Terapia;0;0;0;58;58
3501608;Hospital;0;0;2;7;9
3501608;Outros;0;0;5;6;11
3501608;Pronto Atendimento;0;0;1;0;1
3501608;Unidade Básica de Saúde;1;0;26;0;27
3501608;Unidade de Saúde Mental ;0;0;3;0;3
3501608;Unidade Móvel;1;0;0;0;1
3501608;Vigilância em Saúde;0;0;1;0;1
3501707;Clínica;0;0;2;6;8
3501707;Consultório Isolado;0;0;0;12;12
3501707;Diagnose e Terapia;0;0;0;1;1
3501707;Hospital;2;0;0;0;2
3501707;Outros;0;0;5;1;6
3501707;Pronto Atendimento;0;0;0;1;1
3501707;Unidade Básica de Saúde;0;0;6;1;7
3501707;Unidade de Saúde Mental ;0;0;1;0;1
3501707;Unidade Móvel;0;0;2;0;2
3501707;Vigilância em Saúde;0;0;2;0;2
3501806;Clínica;0;0;1;0;1
3501806;Consultório Isolado;0;0;0;5;5
3501806;Diagnose e Terapia;0;0;0;0;0
3501806;Hospital;0;0;0;0;0
3501806;Outros;0;0;1;1;2
3501806;Pronto Atendimento;0;0;0;0;0
3501806;Unidade Básica de Saúde;0;0;2;0;2
3501806;Unidade de Saúde Mental ;0;0;0;0;0
3501806;Unidade Móvel;0;0;0;0;0
3501806;Vigilância em Saúde;0;0;0;0;0
3501905;Clínica;1;0;5;24;30
3501905;Consultório Isolado;0;0;0;257;257
3501905;Diagnose e Terapia;0;0;1;49;50
3501905;Hospital;0;0;0;4;4
3501905;Outros;0;0;10;5;15
3501905;Pronto Atendimento;0;0;0;1;1
3501905;Unidade Básica de Saúde;0;0;20;0;20
3501905;Unidade de Saúde Mental ;0;0;2;0;2
3501905;Unidade Móvel;0;0;1;1;2
3501905;Vigilância em Saúde;0;0;2;0;2
3502002;Clínica;0;0;0;0;0
3502002;Consultório Isolado;0;0;0;4;4
3502002;Diagnose e Terapia;0;0;0;1;1
3502002;Hospital;0;0;0;0;0
3502002;Outros;0;0;1;0;1
3502002;Pronto Atendimento;0;0;0;0;0
3502002;Unidade Básica de Saúde;0;0;1;0;1
3502002;Unidade de Saúde Mental ;0;0;0;0;0
3502002;Unidade Móvel;0;0;0;0;0
3502002;Vigilância em Saúde;0;0;0;0;0
3502101;Clínica;1;0;4;5;10
3502101;Consultório Isolado;0;0;3;225;228
3502101;Diagnose e Terapia;0;0;1;10;11
3502101;Hospital;1;0;0;2;3
3502101;Outros;0;0;5;1;6
3502101;Pronto Atendimento;0;0;2;1;3
3502101;Unidade Básica de Saúde;1;0;8;0;9
3502101;Unidade de Saúde Mental ;0;0;2;0;2
3502101;Unidade Móvel;0;0;0;15;15
3502101;Vigilância em Saúde;0;0;4;0;4
3502200;Clínica;0;0;1;2;3
3502200;Consultório Isolado;0;0;0;23;23
3502200;Diagnose e Terapia;0;0;1;9;10
3502200;Hospital;0;0;0;1;1
3502200;Outros;0;0;3;0;3
3502200;Pronto Atendimento;0;0;0;0;0
3502200;Unidade Básica de Saúde;0;0;11;0;11
3502200;Unidade de Saúde Mental ;0;0;1;0;1
3502200;Unidade Móvel;0;0;1;0;1
3502200;Vigilância em Saúde;0;0;2;0;2
3502309;Clínica;0;0;0;0;0
3502309;Consultório Isolado;0;0;1;7;8
3502309;Diagnose e Terapia;0;0;0;0;0
3502309;Hospital;0;0;0;0;0
3502309;Outros;0;0;2;0;2
3502309;Pronto Atendimento;0;0;0;0;0
3502309;Unidade Básica de Saúde;0;0;3;0;3
3502309;Unidade de Saúde Mental ;0;0;0;0;0
3502309;Unidade Móvel;0;0;1;0;1
3502309;Vigilância em Saúde;0;0;0;0;0
3502408;Clínica;0;0;1;0;1
3502408;Consultório Isolado;0;0;1;0;1
3502408;Diagnose e Terapia;0;0;0;0;0
3502408;Hospital;0;0;0;0;0
3502408;Outros;0;0;3;0;3
3502408;Pronto Atendimento;0;0;0;0;0
3502408;Unidade Básica de Saúde;0;0;2;0;2
3502408;Unidade de Saúde Mental ;0;0;0;0;0
3502408;Unidade Móvel;0;0;0;0;0
3502408;Vigilância em Saúde;0;0;1;0;1
3502507;Clínica;0;0;2;3;5
3502507;Consultório Isolado;0;0;0;21;21
3502507;Diagnose e Terapia;0;0;2;5;7
3502507;Hospital;0;0;0;1;1
3502507;Outros;0;0;3;0;3
3502507;Pronto Atendimento;0;0;1;0;1
3502507;Unidade Básica de Saúde;0;0;11;0;11
3502507;Unidade de Saúde Mental ;0;0;1;0;1
3502507;Unidade Móvel;0;0;1;0;1
3502507;Vigilância em Saúde;0;0;0;0;0
3502606;Clínica;0;0;0;0;0
3502606;Consultório Isolado;0;0;0;0;0
3502606;Diagnose e Terapia;0;0;0;2;2
3502606;Hospital;0;0;0;1;1
3502606;Outros;0;0;2;0;2
3502606;Pronto Atendimento;0;0;0;0;0
3502606;Unidade Básica de Saúde;0;0;2;0;2
3502606;Unidade de Saúde Mental ;0;0;0;0;0
3502606;Unidade Móvel;0;0;1;0;1
3502606;Vigilância em Saúde;0;0;0;0;0
3502705;Clínica;0;0;5;1;6
3502705;Consultório Isolado;0;0;0;29;29
3502705;Diagnose e Terapia;0;0;1;3;4
3502705;Hospital;0;0;0;1;1
3502705;Outros;0;0;3;0;3
3502705;Pronto Atendimento;0;0;0;0;0
3502705;Unidade Básica de Saúde;0;0;9;0;9
3502705;Unidade de Saúde Mental ;0;0;1;0;1
3502705;Unidade Móvel;0;0;2;0;2
3502705;Vigilância em Saúde;0;0;2;0;2
3502754;Clínica;0;0;2;5;7
3502754;Consultório Isolado;0;0;0;5;5
3502754;Diagnose e Terapia;0;0;0;2;2
3502754;Hospital;0;0;0;0;0
3502754;Outros;0;0;2;0;2
3502754;Pronto Atendimento;0;0;1;0;1
3502754;Unidade Básica de Saúde;0;0;4;0;4
3502754;Unidade de Saúde Mental ;0;0;1;0;1
3502754;Unidade Móvel;0;0;1;1;2
3502754;Vigilância em Saúde;0;0;1;0;1
3502804;Clínica;7;0;10;129;146
3502804;Consultório Isolado;1;0;28;711;740
3502804;Diagnose e Terapia;1;0;0;40;41
3502804;Hospital;0;0;1;9;10
3502804;Outros;4;0;3;13;20
3502804;Pronto Atendimento;0;0;2;1;3
3502804;Unidade Básica de Saúde;1;0;22;0;23
3502804;Unidade de Saúde Mental ;0;0;3;0;3
3502804;Unidade Móvel;1;0;3;2;6
3502804;Vigilância em Saúde;2;0;2;0;4
3502903;Clínica;0;0;2;4;6
3502903;Consultório Isolado;0;0;0;7;7
3502903;Diagnose e Terapia;0;0;0;6;6
3502903;Hospital;0;0;0;9;9
3502903;Outros;0;0;3;1;4
3502903;Pronto Atendimento;0;0;1;0;1
3502903;Unidade Básica de Saúde;0;0;7;0;7
3502903;Unidade de Saúde Mental ;0;0;1;0;1
3502903;Unidade Móvel;0;0;1;1;2
3502903;Vigilância em Saúde;0;0;2;0;2
3503000;Clínica;0;0;0;0;0
3503000;Consultório Isolado;0;0;4;2;6
3503000;Diagnose e Terapia;0;0;1;0;1
3503000;Hospital;0;0;0;0;0
3503000;Outros;0;0;1;0;1
3503000;Pronto Atendimento;0;0;0;0;0
3503000;Unidade Básica de Saúde;0;0;4;0;4
3503000;Unidade de Saúde Mental ;0;0;0;0;0
3503000;Unidade Móvel;0;0;1;0;1
3503000;Vigilância em Saúde;0;0;1;0;1
3503109;Clínica;0;0;0;0;0
3503109;Consultório Isolado;0;0;0;3;3
3503109;Diagnose e Terapia;0;0;1;0;1
3503109;Hospital;0;0;1;0;1
3503109;Outros;0;0;1;0;1
3503109;Pronto Atendimento;0;0;0;0;0
3503109;Unidade Básica de Saúde;0;0;1;0;1
3503109;Unidade de Saúde Mental ;0;0;0;0;0
3503109;Unidade Móvel;0;0;0;0;0
3503109;Vigilância em Saúde;0;0;1;0;1
3503158;Clínica;0;0;0;0;0
3503158;Consultório Isolado;0;0;0;0;0
3503158;Diagnose e Terapia;0;0;0;0;0
3503158;Hospital;0;0;0;0;0
3503158;Outros;0;0;1;0;1
3503158;Pronto Atendimento;0;0;0;0;0
3503158;Unidade Básica de Saúde;0;0;2;0;2
3503158;Unidade de Saúde Mental ;0;0;0;0;0
3503158;Unidade Móvel;0;0;1;0;1
3503158;Vigilância em Saúde;0;0;0;0;0
3503208;Clínica;1;0;21;73;95
3503208;Consultório Isolado;0;0;25;690;715
3503208;Diagnose e Terapia;1;0;3;20;24
3503208;Hospital;0;0;3;8;11
3503208;Outros;4;0;11;5;20
3503208;Pronto Atendimento;0;0;6;1;7
3503208;Unidade Básica de Saúde;6;0;37;1;44
3503208;Unidade de Saúde Mental ;0;0;2;0;2
3503208;Unidade Móvel;1;0;26;3;30
3503208;Vigilância em Saúde;0;0;4;0;4
3503307;Clínica;0;0;6;45;51
3503307;Consultório Isolado;0;0;0;337;337
3503307;Diagnose e Terapia;0;0;1;16;17
3503307;Hospital;0;0;1;4;5
3503307;Outros;0;0;3;3;6
3503307;Pronto Atendimento;0;0;2;0;2
3503307;Unidade Básica de Saúde;0;0;27;0;27
3503307;Unidade de Saúde Mental ;0;0;2;0;2
3503307;Unidade Móvel;0;0;3;0;3
3503307;Vigilância em Saúde;0;0;2;0;2
3503356;Clínica;0;0;0;0;0
3503356;Consultório Isolado;0;0;0;0;0
3503356;Diagnose e Terapia;0;0;0;0;0
3503356;Hospital;0;0;0;0;0
3503356;Outros;0;0;1;0;1
3503356;Pronto Atendimento;0;0;0;0;0
3503356;Unidade Básica de Saúde;0;0;1;0;1
3503356;Unidade de Saúde Mental ;0;0;0;0;0
3503356;Unidade Móvel;0;0;0;0;0
3503356;Vigilância em Saúde;0;0;0;0;0
3503406;Clínica;0;0;0;1;1
3503406;Consultório Isolado;0;0;2;0;2
3503406;Diagnose e Terapia;0;0;0;0;0
3503406;Hospital;0;0;0;1;1
3503406;Outros;0;0;2;3;5
3503406;Pronto Atendimento;0;0;0;0;0
3503406;Unidade Básica de Saúde;0;0;4;0;4
3503406;Unidade de Saúde Mental ;0;0;0;0;0
3503406;Unidade Móvel;0;0;1;0;1
3503406;Vigilância em Saúde;0;0;0;0;0
3503505;Clínica;0;0;0;0;0
3503505;Consultório Isolado;0;0;0;1;1
3503505;Diagnose e Terapia;0;0;0;0;0
3503505;Hospital;0;0;0;0;0
3503505;Outros;0;0;2;0;2
3503505;Pronto Atendimento;0;0;0;0;0
3503505;Unidade Básica de Saúde;0;0;2;0;2
3503505;Unidade de Saúde Mental ;0;0;0;0;0
3503505;Unidade Móvel;0;0;0;0;0
3503505;Vigilância em Saúde;0;0;0;0;0
3503604;Clínica;0;0;1;1;2
3503604;Consultório Isolado;0;0;0;14;14
3503604;Diagnose e Terapia;0;0;0;2;2
3503604;Hospital;0;0;0;0;0
3503604;Outros;0;0;2;0;2
3503604;Pronto Atendimento;0;0;0;0;0
3503604;Unidade Básica de Saúde;0;0;3;0;3
3503604;Unidade de Saúde Mental ;0;0;0;0;0
3503604;Unidade Móvel;0;0;1;0;1
3503604;Vigilância em Saúde;0;0;1;0;1
3503703;Clínica;0;0;1;0;1
3503703;Consultório Isolado;0;0;0;8;8
3503703;Diagnose e Terapia;0;0;1;1;2
3503703;Hospital;0;0;0;1;1
3503703;Outros;0;0;1;0;1
3503703;Pronto Atendimento;0;0;1;0;1
3503703;Unidade Básica de Saúde;0;0;3;0;3
3503703;Unidade de Saúde Mental ;0;0;0;0;0
3503703;Unidade Móvel;0;0;0;0;0
3503703;Vigilância em Saúde;0;0;0;0;0
3503802;Clínica;0;0;3;8;11
3503802;Consultório Isolado;0;0;0;50;50
3503802;Diagnose e Terapia;0;0;1;8;9
3503802;Hospital;0;0;0;3;3
3503802;Outros;0;0;4;3;7
3503802;Pronto Atendimento;0;0;1;0;1
3503802;Unidade Básica de Saúde;0;0;15;4;19
3503802;Unidade de Saúde Mental ;0;0;1;0;1
3503802;Unidade Móvel;0;0;1;0;1
3503802;Vigilância em Saúde;0;0;0;0;0
3503901;Clínica;0;0;4;20;24
3503901;Consultório Isolado;0;0;0;50;50
3503901;Diagnose e Terapia;0;0;0;10;10
3503901;Hospital;0;0;2;2;4
3503901;Outros;0;0;2;0;2
3503901;Pronto Atendimento;0;0;0;0;0
3503901;Unidade Básica de Saúde;0;0;7;0;7
3503901;Unidade de Saúde Mental ;0;0;0;0;0
3503901;Unidade Móvel;0;0;2;1;3
3503901;Vigilância em Saúde;0;0;1;0;1
3503950;Clínica;0;0;0;0;0
3503950;Consultório Isolado;0;0;0;0;0
3503950;Diagnose e Terapia;0;0;0;0;0
3503950;Hospital;0;0;0;0;0
3503950;Outros;0;0;1;0;1
3503950;Pronto Atendimento;0;0;0;0;0
3503950;Unidade Básica de Saúde;0;0;1;0;1
3503950;Unidade de Saúde Mental ;0;0;0;0;0
3503950;Unidade Móvel;0;0;0;0;0
3503950;Vigilância em Saúde;0;0;0;0;0
3504008;Clínica;1;0;6;19;26
3504008;Consultório Isolado;0;0;7;363;370
3504008;Diagnose e Terapia;0;0;0;23;23
3504008;Hospital;1;0;1;10;12
3504008;Outros;3;0;14;3;20
3504008;Pronto Atendimento;0;0;3;1;4
3504008;Unidade Básica de Saúde;1;0;22;0;23
3504008;Unidade de Saúde Mental ;0;0;2;0;2
3504008;Unidade Móvel;0;0;2;0;2
3504008;Vigilância em Saúde;0;0;0;0;0
3504107;Clínica;1;0;3;49;53
3504107;Consultório Isolado;0;0;0;331;331
3504107;Diagnose e Terapia;0;0;1;54;55
3504107;Hospital;0;0;0;3;3
3504107;Outros;0;0;3;9;12
3504107;Pronto Atendimento;0;0;1;0;1
3504107;Unidade Básica de Saúde;0;0;20;0;20
3504107;Unidade de Saúde Mental ;0;0;1;0;1
3504107;Unidade Móvel;0;0;8;0;8
3504107;Vigilância em Saúde;0;0;1;0;1
3504206;Clínica;0;0;1;0;1
3504206;Consultório Isolado;0;0;3;19;22
3504206;Diagnose e Terapia;0;0;0;2;2
3504206;Hospital;0;0;0;1;1
3504206;Outros;0;0;3;0;3
3504206;Pronto Atendimento;0;0;0;0;0
3504206;Unidade Básica de Saúde;0;0;6;0;6
3504206;Unidade de Saúde Mental ;0;0;0;0;0
3504206;Unidade Móvel;0;0;0;0;0
3504206;Vigilância em Saúde;0;0;1;0;1
3504305;Clínica;0;0;0;0;0
3504305;Consultório Isolado;0;0;0;0;0
3504305;Diagnose e Terapia;0;0;0;0;0
3504305;Hospital;0;0;0;0;0
3504305;Outros;0;0;1;0;1
3504305;Pronto Atendimento;0;0;0;0;0
3504305;Unidade Básica de Saúde;0;0;1;0;1
3504305;Unidade de Saúde Mental ;0;0;0;0;0
3504305;Unidade Móvel;0;0;0;0;0
3504305;Vigilância em Saúde;0;0;0;0;0
3504404;Clínica;0;0;1;0;1
3504404;Consultório Isolado;0;0;3;5;8
3504404;Diagnose e Terapia;0;0;0;2;2
3504404;Hospital;0;0;0;0;0
3504404;Outros;0;0;1;2;3
3504404;Pronto Atendimento;0;0;0;0;0
3504404;Unidade Básica de Saúde;1;0;5;0;6
3504404;Unidade de Saúde Mental ;0;0;0;0;0
3504404;Unidade Móvel;0;0;0;0;0
3504404;Vigilância em Saúde;0;0;0;0;0
3504503;Clínica;0;0;6;12;18
3504503;Consultório Isolado;0;0;0;220;220
3504503;Diagnose e Terapia;0;0;1;21;22
3504503;Hospital;0;0;0;1;1
3504503;Outros;1;0;2;3;6
3504503;Pronto Atendimento;0;0;1;0;1
3504503;Unidade Básica de Saúde;3;0;17;0;20
3504503;Unidade de Saúde Mental ;0;0;1;0;1
3504503;Unidade Móvel;0;0;3;0;3
3504503;Vigilância em Saúde;0;0;1;0;1
3504602;Clínica;0;0;1;3;4
3504602;Consultório Isolado;0;0;0;5;5
3504602;Diagnose e Terapia;0;0;0;2;2
3504602;Hospital;0;0;0;0;0
3504602;Outros;0;0;1;0;1
3504602;Pronto Atendimento;0;0;0;0;0
3504602;Unidade Básica de Saúde;0;0;3;0;3
3504602;Unidade de Saúde Mental ;0;0;0;0;0
3504602;Unidade Móvel;0;0;0;0;0
3504602;Vigilância em Saúde;0;0;1;0;1
3504701;Clínica;0;0;0;0;0
3504701;Consultório Isolado;0;0;0;0;0
3504701;Diagnose e Terapia;0;0;0;0;0
3504701;Hospital;0;0;0;0;0
3504701;Outros;0;0;1;0;1
3504701;Pronto Atendimento;0;0;0;0;0
3504701;Unidade Básica de Saúde;2;0;2;0;4
3504701;Unidade de Saúde Mental ;0;0;0;0;0
3504701;Unidade Móvel;0;0;0;0;0
3504701;Vigilância em Saúde;0;0;0;0;0
3504800;Clínica;0;0;0;0;0
3504800;Consultório Isolado;0;0;1;2;3
3504800;Diagnose e Terapia;0;0;0;1;1
3504800;Hospital;0;0;0;0;0
3504800;Outros;0;0;1;0;1
3504800;Pronto Atendimento;0;0;0;0;0
3504800;Unidade Básica de Saúde;0;0;3;0;3
3504800;Unidade de Saúde Mental ;0;0;0;0;0
3504800;Unidade Móvel;0;0;0;0;0
3504800;Vigilância em Saúde;0;0;0;0;0
3504909;Clínica;0;0;1;1;2
3504909;Consultório Isolado;0;0;0;1;1
3504909;Diagnose e Terapia;0;0;0;1;1
3504909;Hospital;0;0;0;0;0
3504909;Outros;0;0;2;2;4
3504909;Pronto Atendimento;0;0;0;0;0
3504909;Unidade Básica de Saúde;0;0;6;0;6
3504909;Unidade de Saúde Mental ;0;0;1;0;1
3504909;Unidade Móvel;0;0;1;0;1
3504909;Vigilância em Saúde;0;0;0;0;0
3505005;Clínica;0;0;0;0;0
3505005;Consultório Isolado;0;0;0;0;0
3505005;Diagnose e Terapia;0;0;0;0;0
3505005;Hospital;0;0;0;0;0
3505005;Outros;0;0;2;0;2
3505005;Pronto Atendimento;0;0;0;0;0
3505005;Unidade Básica de Saúde;0;0;2;0;2
3505005;Unidade de Saúde Mental ;0;0;0;0;0
3505005;Unidade Móvel;0;0;0;0;0
3505005;Vigilância em Saúde;0;0;1;0;1
3505104;Clínica;0;0;0;0;0
3505104;Consultório Isolado;0;0;0;0;0
3505104;Diagnose e Terapia;0;0;0;0;0
3505104;Hospital;0;0;0;0;0
3505104;Outros;0;0;2;0;2
3505104;Pronto Atendimento;0;0;0;0;0
3505104;Unidade Básica de Saúde;0;0;1;0;1
3505104;Unidade de Saúde Mental ;0;0;0;0;0
3505104;Unidade Móvel;0;0;0;0;0
3505104;Vigilância em Saúde;0;0;0;0;0
3505203;Clínica;0;0;3;8;11
3505203;Consultório Isolado;0;0;0;59;59
3505203;Diagnose e Terapia;0;0;1;10;11
3505203;Hospital;0;0;0;1;1
3505203;Outros;0;0;1;0;1
3505203;Pronto Atendimento;0;0;0;0;0
3505203;Unidade Básica de Saúde;0;0;6;0;6
3505203;Unidade de Saúde Mental ;0;0;2;0;2
3505203;Unidade Móvel;0;0;0;0;0
3505203;Vigilância em Saúde;0;0;0;0;0
3505302;Clínica;0;0;1;4;5
3505302;Consultório Isolado;0;0;0;82;82
3505302;Diagnose e Terapia;0;0;1;8;9
3505302;Hospital;0;0;0;1;1
3505302;Outros;0;0;2;0;2
3505302;Pronto Atendimento;0;0;0;0;0
3505302;Unidade Básica de Saúde;0;0;8;0;8
3505302;Unidade de Saúde Mental ;0;0;1;0;1
3505302;Unidade Móvel;0;0;0;0;0
3505302;Vigilância em Saúde;0;0;0;0;0
3505351;Clínica;0;0;0;0;0
3505351;Consultório Isolado;0;0;0;0;0
3505351;Diagnose e Terapia;0;0;0;0;0
3505351;Hospital;0;0;0;0;0
3505351;Outros;0;0;3;0;3
3505351;Pronto Atendimento;0;0;0;0;0
3505351;Unidade Básica de Saúde;0;0;5;0;5
3505351;Unidade de Saúde Mental ;0;0;0;0;0
3505351;Unidade Móvel;0;0;0;0;0
3505351;Vigilância em Saúde;0;0;1;0;1
3505401;Clínica;0;0;0;0;0
3505401;Consultório Isolado;0;0;0;0;0
3505401;Diagnose e Terapia;0;0;0;0;0
3505401;Hospital;0;0;0;0;0
3505401;Outros;0;0;2;0;2
3505401;Pronto Atendimento;0;0;1;0;1
3505401;Unidade Básica de Saúde;0;0;5;0;5
3505401;Unidade de Saúde Mental ;0;0;0;0;0
3505401;Unidade Móvel;0;0;1;0;1
3505401;Vigilância em Saúde;0;0;0;0;0
3505500;Clínica;2;0;8;28;38
3505500;Consultório Isolado;0;0;1;272;273
3505500;Diagnose e Terapia;0;0;1;11;12
3505500;Hospital;2;0;0;7;9
3505500;Outros;5;0;9;3;17
3505500;Pronto Atendimento;0;0;1;1;2
3505500;Unidade Básica de Saúde;0;0;16;0;16
3505500;Unidade de Saúde Mental ;0;0;1;0;1
3505500;Unidade Móvel;0;0;4;0;4
3505500;Vigilância em Saúde;0;0;1;0;1
3505609;Clínica;0;0;4;5;9
3505609;Consultório Isolado;0;0;0;9;9
3505609;Diagnose e Terapia;0;0;0;3;3
3505609;Hospital;0;0;0;0;0
3505609;Outros;0;0;2;0;2
3505609;Pronto Atendimento;0;0;0;1;1
3505609;Unidade Básica de Saúde;0;0;8;1;9
3505609;Unidade de Saúde Mental ;0;0;0;0;0
3505609;Unidade Móvel;0;0;1;0;1
3505609;Vigilância em Saúde;0;0;3;0;3
3505708;Clínica;0;0;7;62;69
3505708;Consultório Isolado;0;0;7;324;331
3505708;Diagnose e Terapia;0;0;1;21;22
3505708;Hospital;0;0;2;1;3
3505708;Outros;0;0;5;4;9
3505708;Pronto Atendimento;0;0;7;3;10
3505708;Unidade Básica de Saúde;0;0;20;0;20
3505708;Unidade de Saúde Mental ;0;0;3;0;3
3505708;Unidade Móvel;0;0;0;0;0
3505708;Vigilância em Saúde;0;0;1;0;1
3505807;Clínica;0;0;3;6;9
3505807;Consultório Isolado;0;0;0;14;14
3505807;Diagnose e Terapia;0;0;1;1;2
3505807;Hospital;0;0;0;1;1
3505807;Outros;0;0;6;0;6
3505807;Pronto Atendimento;0;0;1;0;1
3505807;Unidade Básica de Saúde;0;0;6;0;6
3505807;Unidade de Saúde Mental ;0;0;1;0;1
3505807;Unidade Móvel;0;0;0;0;0
3505807;Vigilância em Saúde;0;0;1;0;1
3505906;Clínica;0;0;4;10;14
3505906;Consultório Isolado;1;0;1;293;295
3505906;Diagnose e Terapia;0;0;1;10;11
3505906;Hospital;0;0;0;1;1
3505906;Outros;0;0;3;1;4
3505906;Pronto Atendimento;0;0;1;1;2
3505906;Unidade Básica de Saúde;0;0;11;0;11
3505906;Unidade de Saúde Mental ;0;0;1;0;1
3505906;Unidade Móvel;0;0;2;0;2
3505906;Vigilância em Saúde;0;0;1;0;1
3506003;Clínica;3;0;15;80;98
3506003;Consultório Isolado;0;0;33;783;816
3506003;Diagnose e Terapia;2;0;0;49;51
3506003;Hospital;7;0;1;12;20
3506003;Outros;4;1;7;10;22
3506003;Pronto Atendimento;0;0;5;0;5
3506003;Unidade Básica de Saúde;5;0;26;1;32
3506003;Unidade de Saúde Mental ;0;0;5;0;5
3506003;Unidade Móvel;0;0;16;1;17
3506003;Vigilância em Saúde;0;0;4;0;4
3506102;Clínica;0;0;5;56;61
3506102;Consultório Isolado;0;0;0;229;229
3506102;Diagnose e Terapia;0;0;1;12;13
3506102;Hospital;1;0;1;5;7
3506102;Outros;0;0;3;1;4
3506102;Pronto Atendimento;0;0;1;0;1
3506102;Unidade Básica de Saúde;0;0;18;0;18
3506102;Unidade de Saúde Mental ;0;0;2;0;2
3506102;Unidade Móvel;0;0;0;1;1
3506102;Vigilância em Saúde;0;0;0;0;0
3506201;Clínica;0;0;0;0;0
3506201;Consultório Isolado;0;0;1;0;1
3506201;Diagnose e Terapia;0;0;1;0;1
3506201;Hospital;0;0;0;0;0
3506201;Outros;0;0;1;0;1
3506201;Pronto Atendimento;0;0;0;0;0
3506201;Unidade Básica de Saúde;0;0;1;0;1
3506201;Unidade de Saúde Mental ;0;0;0;0;0
3506201;Unidade Móvel;0;0;0;0;0
3506201;Vigilância em Saúde;0;0;0;0;0
3506300;Clínica;0;0;1;1;2
3506300;Consultório Isolado;0;0;0;6;6
3506300;Diagnose e Terapia;0;0;0;2;2
3506300;Hospital;0;0;0;1;1
3506300;Outros;0;0;1;0;1
3506300;Pronto Atendimento;0;0;0;0;0
3506300;Unidade Básica de Saúde;1;0;4;0;5
3506300;Unidade de Saúde Mental ;0;0;1;0;1
3506300;Unidade Móvel;0;0;1;0;1
3506300;Vigilância em Saúde;0;0;0;0;0
3506359;Clínica;0;0;5;10;15
3506359;Consultório Isolado;0;0;0;17;17
3506359;Diagnose e Terapia;0;0;0;12;12
3506359;Hospital;0;0;1;0;1
3506359;Outros;0;0;1;1;2
3506359;Pronto Atendimento;0;0;1;0;1
3506359;Unidade Básica de Saúde;0;0;6;0;6
3506359;Unidade de Saúde Mental ;0;0;1;0;1
3506359;Unidade Móvel;0;0;5;0;5
3506359;Vigilância em Saúde;0;0;2;0;2
3506409;Clínica;0;0;0;0;0
3506409;Consultório Isolado;0;0;1;5;6
3506409;Diagnose e Terapia;0;0;0;1;1
3506409;Hospital;0;0;0;1;1
3506409;Outros;0;0;1;1;2
3506409;Pronto Atendimento;0;0;0;0;0
3506409;Unidade Básica de Saúde;0;0;1;0;1
3506409;Unidade de Saúde Mental ;0;0;0;0;0
3506409;Unidade Móvel;0;0;0;0;0
3506409;Vigilância em Saúde;0;0;1;0;1
3506508;Clínica;1;0;9;33;43
3506508;Consultório Isolado;0;0;11;173;184
3506508;Diagnose e Terapia;0;0;0;22;22
3506508;Hospital;0;0;0;3;3
3506508;Outros;0;0;2;6;8
3506508;Pronto Atendimento;0;0;2;0;2
3506508;Unidade Básica de Saúde;1;0;11;0;12
3506508;Unidade de Saúde Mental ;0;0;0;0;0
3506508;Unidade Móvel;0;0;0;0;0
3506508;Vigilância em Saúde;0;0;0;0;0
3506607;Clínica;0;0;1;1;2
3506607;Consultório Isolado;0;0;1;9;10
3506607;Diagnose e Terapia;0;0;0;2;2
3506607;Hospital;0;0;1;0;1
3506607;Outros;0;0;4;1;5
3506607;Pronto Atendimento;0;0;1;0;1
3506607;Unidade Básica de Saúde;0;0;6;0;6
3506607;Unidade de Saúde Mental ;0;0;1;0;1
3506607;Unidade Móvel;0;0;1;0;1
3506607;Vigilância em Saúde;0;0;1;0;1
3506706;Clínica;0;0;1;0;1
3506706;Consultório Isolado;0;0;0;12;12
3506706;Diagnose e Terapia;0;0;2;0;2
3506706;Hospital;0;0;0;1;1
3506706;Outros;0;0;3;0;3
3506706;Pronto Atendimento;0;0;0;0;0
3506706;Unidade Básica de Saúde;0;0;4;0;4
3506706;Unidade de Saúde Mental ;0;0;0;0;0
3506706;Unidade Móvel;0;0;2;0;2
3506706;Vigilância em Saúde;0;0;0;0;0
3506805;Clínica;0;0;1;2;3
3506805;Consultório Isolado;0;0;1;13;14
3506805;Diagnose e Terapia;0;0;0;0;0
3506805;Hospital;0;0;0;1;1
3506805;Outros;0;0;0;0;0
3506805;Pronto Atendimento;0;0;0;0;0
3506805;Unidade Básica de Saúde;0;0;5;0;5
3506805;Unidade de Saúde Mental ;0;0;0;0;0
3506805;Unidade Móvel;0;0;0;0;0
3506805;Vigilância em Saúde;0;0;0;0;0
3506904;Clínica;0;0;0;2;2
3506904;Consultório Isolado;0;0;0;0;0
3506904;Diagnose e Terapia;0;0;0;0;0
3506904;Hospital;0;0;0;0;0
3506904;Outros;0;0;0;0;0
3506904;Pronto Atendimento;0;0;0;0;0
3506904;Unidade Básica de Saúde;0;0;1;0;1
3506904;Unidade de Saúde Mental ;0;0;0;0;0
3506904;Unidade Móvel;0;0;1;0;1
3506904;Vigilância em Saúde;0;0;1;0;1
3507001;Clínica;0;0;2;22;24
3507001;Consultório Isolado;0;0;0;95;95
3507001;Diagnose e Terapia;0;0;0;11;11
3507001;Hospital;0;0;0;1;1
3507001;Outros;0;0;5;2;7
3507001;Pronto Atendimento;0;0;0;0;0
3507001;Unidade Básica de Saúde;0;0;10;0;10
3507001;Unidade de Saúde Mental ;0;0;2;0;2
3507001;Unidade Móvel;0;0;3;0;3
3507001;Vigilância em Saúde;0;0;2;0;2
3507100;Clínica;0;0;0;1;1
3507100;Consultório Isolado;0;0;0;14;14
3507100;Diagnose e Terapia;0;0;1;3;4
3507100;Hospital;0;0;0;0;0
3507100;Outros;0;0;1;0;1
3507100;Pronto Atendimento;0;0;0;0;0
3507100;Unidade Básica de Saúde;0;0;3;0;3
3507100;Unidade de Saúde Mental ;0;0;0;0;0
3507100;Unidade Móvel;0;0;1;0;1
3507100;Vigilância em Saúde;0;0;0;0;0
3507159;Clínica;0;0;0;0;0
3507159;Consultório Isolado;0;0;0;0;0
3507159;Diagnose e Terapia;0;0;0;0;0
3507159;Hospital;0;0;0;0;0
3507159;Outros;0;0;2;0;2
3507159;Pronto Atendimento;0;0;0;0;0
3507159;Unidade Básica de Saúde;0;0;2;0;2
3507159;Unidade de Saúde Mental ;0;0;0;0;0
3507159;Unidade Móvel;0;0;1;0;1
3507159;Vigilância em Saúde;0;0;1;0;1
3507209;Clínica;0;0;0;0;0
3507209;Consultório Isolado;0;0;0;0;0
3507209;Diagnose e Terapia;0;0;0;0;0
3507209;Hospital;0;0;0;0;0
3507209;Outros;0;0;1;0;1
3507209;Pronto Atendimento;0;0;0;0;0
3507209;Unidade Básica de Saúde;0;0;1;0;1
3507209;Unidade de Saúde Mental ;0;0;0;0;0
3507209;Unidade Móvel;0;0;0;0;0
3507209;Vigilância em Saúde;0;0;0;0;0
3507308;Clínica;0;0;0;0;0
3507308;Consultório Isolado;0;0;0;1;1
3507308;Diagnose e Terapia;0;0;0;0;0
3507308;Hospital;0;0;0;0;0
3507308;Outros;0;0;2;0;2
3507308;Pronto Atendimento;0;0;0;0;0
3507308;Unidade Básica de Saúde;0;0;3;0;3
3507308;Unidade de Saúde Mental ;0;0;0;0;0
3507308;Unidade Móvel;0;0;0;0;0
3507308;Vigilância em Saúde;0;0;0;0;0
3507407;Clínica;0;0;1;8;9
3507407;Consultório Isolado;0;0;0;22;22
3507407;Diagnose e Terapia;0;0;0;6;6
3507407;Hospital;0;0;0;1;1
3507407;Outros;0;0;1;0;1
3507407;Pronto Atendimento;0;0;1;0;1
3507407;Unidade Básica de Saúde;0;0;7;0;7
3507407;Unidade de Saúde Mental ;0;0;1;0;1
3507407;Unidade Móvel;0;0;0;0;0
3507407;Vigilância em Saúde;0;0;0;0;0
3507456;Clínica;0;0;1;0;1
3507456;Consultório Isolado;0;0;0;1;1
3507456;Diagnose e Terapia;0;0;0;0;0
3507456;Hospital;0;0;0;0;0
3507456;Outros;0;0;1;0;1
3507456;Pronto Atendimento;0;0;0;0;0
3507456;Unidade Básica de Saúde;0;0;2;0;2
3507456;Unidade de Saúde Mental ;0;0;0;0;0
3507456;Unidade Móvel;0;0;0;0;0
3507456;Vigilância em Saúde;0;0;0;0;0
3507506;Clínica;5;0;7;36;48
3507506;Consultório Isolado;2;0;1;672;675
3507506;Diagnose e Terapia;0;0;2;8;10
3507506;Hospital;2;0;1;5;8
3507506;Outros;3;0;10;6;19
3507506;Pronto Atendimento;0;0;0;1;1
3507506;Unidade Básica de Saúde;1;0;24;0;25
3507506;Unidade de Saúde Mental ;2;0;2;0;4
3507506;Unidade Móvel;1;0;3;0;4
3507506;Vigilância em Saúde;0;0;3;0;3
3507605;Clínica;0;0;8;60;68
3507605;Consultório Isolado;0;0;2;339;341
3507605;Diagnose e Terapia;1;0;0;33;34
3507605;Hospital;0;0;0;11;11
3507605;Outros;0;0;10;4;14
3507605;Pronto Atendimento;0;0;3;0;3
3507605;Unidade Básica de Saúde;0;0;34;0;34
3507605;Unidade de Saúde Mental ;0;0;3;1;4
3507605;Unidade Móvel;1;0;4;0;5
3507605;Vigilância em Saúde;0;0;2;0;2
3507704;Clínica;0;0;0;0;0
3507704;Consultório Isolado;0;0;1;0;1
3507704;Diagnose e Terapia;0;0;0;0;0
3507704;Hospital;0;0;0;0;0
3507704;Outros;0;0;2;0;2
3507704;Pronto Atendimento;0;0;0;0;0
3507704;Unidade Básica de Saúde;0;0;1;0;1
3507704;Unidade de Saúde Mental ;0;0;0;0;0
3507704;Unidade Móvel;0;0;0;0;0
3507704;Vigilância em Saúde;0;0;1;0;1
3507753;Clínica;0;0;0;0;0
3507753;Consultório Isolado;0;0;1;0;1
3507753;Diagnose e Terapia;0;0;0;0;0
3507753;Hospital;0;0;0;0;0
3507753;Outros;0;0;1;0;1
3507753;Pronto Atendimento;0;0;0;0;0
3507753;Unidade Básica de Saúde;0;0;1;0;1
3507753;Unidade de Saúde Mental ;0;0;0;0;0
3507753;Unidade Móvel;0;0;0;0;0
3507753;Vigilância em Saúde;0;0;1;0;1
3507803;Clínica;0;0;2;2;4
3507803;Consultório Isolado;0;0;0;39;39
3507803;Diagnose e Terapia;0;0;0;4;4
3507803;Hospital;0;0;0;0;0
3507803;Outros;0;0;1;0;1
3507803;Pronto Atendimento;0;0;1;0;1
3507803;Unidade Básica de Saúde;0;0;6;0;6
3507803;Unidade de Saúde Mental ;0;0;0;0;0
3507803;Unidade Móvel;0;0;1;0;1
3507803;Vigilância em Saúde;0;0;0;0;0
3507902;Clínica;0;0;1;1;2
3507902;Consultório Isolado;0;0;0;75;75
3507902;Diagnose e Terapia;0;0;0;4;4
3507902;Hospital;0;0;0;1;1
3507902;Outros;0;0;2;1;3
3507902;Pronto Atendimento;0;0;0;0;0
3507902;Unidade Básica de Saúde;0;0;7;0;7
3507902;Unidade de Saúde Mental ;0;0;0;0;0
3507902;Unidade Móvel;0;0;0;0;0
3507902;Vigilância em Saúde;0;0;0;0;0
3508009;Clínica;0;0;2;1;3
3508009;Consultório Isolado;0;0;3;3;6
3508009;Diagnose e Terapia;0;0;0;3;3
3508009;Hospital;0;0;0;0;0
3508009;Outros;0;0;4;0;4
3508009;Pronto Atendimento;0;0;1;0;1
3508009;Unidade Básica de Saúde;0;0;11;0;11
3508009;Unidade de Saúde Mental ;0;0;1;0;1
3508009;Unidade Móvel;0;0;0;0;0
3508009;Vigilância em Saúde;0;0;1;0;1
3508108;Clínica;0;0;2;6;8
3508108;Consultório Isolado;0;0;0;13;13
3508108;Diagnose e Terapia;0;0;0;2;2
3508108;Hospital;0;0;0;1;1
3508108;Outros;0;0;3;0;3
3508108;Pronto Atendimento;0;0;0;0;0
3508108;Unidade Básica de Saúde;0;0;2;0;2
3508108;Unidade de Saúde Mental ;0;0;1;0;1
3508108;Unidade Móvel;0;0;0;0;0
3508108;Vigilância em Saúde;0;0;2;0;2
3508207;Clínica;0;0;0;0;0
3508207;Consultório Isolado;0;0;0;2;2
3508207;Diagnose e Terapia;0;0;0;2;2
3508207;Hospital;0;0;0;0;0
3508207;Outros;0;0;1;0;1
3508207;Pronto Atendimento;0;0;0;0;0
3508207;Unidade Básica de Saúde;0;0;2;0;2
3508207;Unidade de Saúde Mental ;0;0;0;0;0
3508207;Unidade Móvel;0;0;0;0;0
3508207;Vigilância em Saúde;0;0;0;0;0
3508306;Clínica;0;0;1;0;1
3508306;Consultório Isolado;0;0;0;0;0
3508306;Diagnose e Terapia;0;0;0;0;0
3508306;Hospital;0;0;0;0;0
3508306;Outros;0;0;1;0;1
3508306;Pronto Atendimento;0;0;0;0;0
3508306;Unidade Básica de Saúde;0;0;2;0;2
3508306;Unidade de Saúde Mental ;0;0;0;0;0
3508306;Unidade Móvel;0;0;0;0;0
3508306;Vigilância em Saúde;0;0;0;0;0
3508405;Clínica;0;0;5;10;15
3508405;Consultório Isolado;0;0;0;10;10
3508405;Diagnose e Terapia;0;0;0;8;8
3508405;Hospital;0;0;0;2;2
3508405;Outros;0;0;4;0;4
3508405;Pronto Atendimento;0;0;1;0;1
3508405;Unidade Básica de Saúde;0;0;8;0;8
3508405;Unidade de Saúde Mental ;0;0;1;0;1
3508405;Unidade Móvel;0;0;0;0;0
3508405;Vigilância em Saúde;0;0;0;0;0
3508504;Clínica;0;0;4;13;17
3508504;Consultório Isolado;0;0;0;283;283
3508504;Diagnose e Terapia;0;0;0;11;11
3508504;Hospital;0;0;0;5;5
3508504;Outros;0;0;7;1;8
3508504;Pronto Atendimento;0;0;0;2;2
3508504;Unidade Básica de Saúde;0;0;29;0;29
3508504;Unidade de Saúde Mental ;0;0;3;0;3
3508504;Unidade Móvel;0;0;3;0;3
3508504;Vigilância em Saúde;0;0;3;0;3
3508603;Clínica;0;0;4;9;13
3508603;Consultório Isolado;0;0;0;41;41
3508603;Diagnose e Terapia;0;0;0;3;3
3508603;Hospital;0;0;0;1;1
3508603;Outros;0;0;4;4;8
3508603;Pronto Atendimento;0;0;1;0;1
3508603;Unidade Básica de Saúde;0;0;11;0;11
3508603;Unidade de Saúde Mental ;0;0;1;0;1
3508603;Unidade Móvel;0;0;0;0;0
3508603;Vigilância em Saúde;0;0;0;0;0
3508702;Clínica;0;0;2;4;6
3508702;Consultório Isolado;0;0;0;20;20
3508702;Diagnose e Terapia;0;0;1;5;6
3508702;Hospital;0;0;0;1;1
3508702;Outros;0;0;2;1;3
3508702;Pronto Atendimento;0;0;0;0;0
3508702;Unidade Básica de Saúde;0;0;6;0;6
3508702;Unidade de Saúde Mental ;0;0;0;0;0
3508702;Unidade Móvel;0;0;0;0;0
3508702;Vigilância em Saúde;0;0;0;0;0
3508801;Clínica;0;0;0;3;3
3508801;Consultório Isolado;0;0;0;36;36
3508801;Diagnose e Terapia;0;0;0;8;8
3508801;Hospital;0;0;0;1;1
3508801;Outros;0;0;2;0;2
3508801;Pronto Atendimento;0;0;0;0;0
3508801;Unidade Básica de Saúde;0;0;6;0;6
3508801;Unidade de Saúde Mental ;0;0;1;0;1
3508801;Unidade Móvel;0;0;0;0;0
3508801;Vigilância em Saúde;0;0;0;0;0
3508900;Clínica;0;0;1;0;1
3508900;Consultório Isolado;0;0;0;0;0
3508900;Diagnose e Terapia;0;0;0;0;0
3508900;Hospital;0;0;0;0;0
3508900;Outros;0;0;2;0;2
3508900;Pronto Atendimento;0;0;0;0;0
3508900;Unidade Básica de Saúde;0;0;2;0;2
3508900;Unidade de Saúde Mental ;0;0;0;0;0
3508900;Unidade Móvel;0;0;0;0;0
3508900;Vigilância em Saúde;0;0;0;0;0
3509007;Clínica;0;0;3;24;27
3509007;Consultório Isolado;0;0;2;28;30
3509007;Diagnose e Terapia;0;0;0;7;7
3509007;Hospital;1;0;1;2;4
3509007;Outros;0;0;4;3;7
3509007;Pronto Atendimento;0;0;0;1;1
3509007;Unidade Básica de Saúde;0;0;16;0;16
3509007;Unidade de Saúde Mental ;0;0;1;0;1
3509007;Unidade Móvel;0;0;1;0;1
3509007;Vigilância em Saúde;0;0;2;0;2
3509106;Clínica;0;0;0;0;0
3509106;Consultório Isolado;0;0;1;0;1
3509106;Diagnose e Terapia;0;0;0;0;0
3509106;Hospital;0;0;0;0;0
3509106;Outros;0;0;1;0;1
3509106;Pronto Atendimento;0;0;0;0;0
3509106;Unidade Básica de Saúde;2;0;3;0;5
3509106;Unidade de Saúde Mental ;0;0;0;0;0
3509106;Unidade Móvel;0;0;0;0;0
3509106;Vigilância em Saúde;0;0;1;0;1
3509205;Clínica;0;0;2;26;28
3509205;Consultório Isolado;0;0;0;57;57
3509205;Diagnose e Terapia;0;0;0;7;7
3509205;Hospital;0;0;2;1;3
3509205;Outros;0;0;3;0;3
3509205;Pronto Atendimento;0;0;1;0;1
3509205;Unidade Básica de Saúde;0;0;12;0;12
3509205;Unidade de Saúde Mental ;0;0;2;0;2
3509205;Unidade Móvel;0;0;2;0;2
3509205;Vigilância em Saúde;0;0;2;0;2
3509254;Clínica;0;0;1;4;5
3509254;Consultório Isolado;0;0;0;23;23
3509254;Diagnose e Terapia;0;0;0;5;5
3509254;Hospital;0;0;0;0;0
3509254;Outros;0;0;3;0;3
3509254;Pronto Atendimento;0;0;1;0;1
3509254;Unidade Básica de Saúde;0;0;10;0;10
3509254;Unidade de Saúde Mental ;0;0;1;0;1
3509254;Unidade Móvel;0;0;1;0;1
3509254;Vigilância em Saúde;0;0;1;0;1
3509304;Clínica;0;0;0;0;0
3509304;Consultório Isolado;0;0;0;4;4
3509304;Diagnose e Terapia;0;0;0;3;3
3509304;Hospital;0;0;0;1;1
3509304;Outros;0;0;3;0;3
3509304;Pronto Atendimento;0;0;0;0;0
3509304;Unidade Básica de Saúde;0;0;3;0;3
3509304;Unidade de Saúde Mental ;0;0;0;0;0
3509304;Unidade Móvel;0;0;1;0;1
3509304;Vigilância em Saúde;0;0;0;0;0
3509403;Clínica;0;0;4;12;16
3509403;Consultório Isolado;0;0;2;48;50
3509403;Diagnose e Terapia;0;0;1;2;3
3509403;Hospital;0;0;0;1;1
3509403;Outros;0;0;3;0;3
3509403;Pronto Atendimento;0;0;1;0;1
3509403;Unidade Básica de Saúde;0;0;14;0;14
3509403;Unidade de Saúde Mental ;0;0;0;0;0
3509403;Unidade Móvel;0;0;4;1;5
3509403;Vigilância em Saúde;0;0;1;0;1
3509452;Clínica;0;0;0;1;1
3509452;Consultório Isolado;0;0;0;0;0
3509452;Diagnose e Terapia;0;0;0;0;0
3509452;Hospital;0;0;0;0;0
3509452;Outros;0;0;2;0;2
3509452;Pronto Atendimento;0;0;0;0;0
3509452;Unidade Básica de Saúde;0;0;3;0;3
3509452;Unidade de Saúde Mental ;0;0;0;0;0
3509452;Unidade Móvel;0;0;0;0;0
3509452;Vigilância em Saúde;0;0;0;0;0
3509502;Clínica;1;0;24;395;420
3509502;Consultório Isolado;0;0;1;2557;2558
3509502;Diagnose e Terapia;1;0;2;206;209
3509502;Hospital;2;0;6;44;52
3509502;Outros;5;0;12;57;74
3509502;Pronto Atendimento;0;0;5;0;5
3509502;Unidade Básica de Saúde;4;0;72;0;76
3509502;Unidade de Saúde Mental ;0;0;14;0;14
3509502;Unidade Móvel;0;0;20;3;23
3509502;Vigilância em Saúde;0;0;7;0;7
3509601;Clínica;0;0;4;17;21
3509601;Consultório Isolado;0;0;0;17;17
3509601;Diagnose e Terapia;0;0;0;8;8
3509601;Hospital;0;0;1;0;1
3509601;Outros;0;0;3;2;5
3509601;Pronto Atendimento;0;0;0;0;0
3509601;Unidade Básica de Saúde;0;0;10;1;11
3509601;Unidade de Saúde Mental ;0;0;1;0;1
3509601;Unidade Móvel;0;0;0;0;0
3509601;Vigilância em Saúde;0;0;2;0;2
3509700;Clínica;0;0;2;8;10
3509700;Consultório Isolado;0;0;0;52;52
3509700;Diagnose e Terapia;0;0;0;5;5
3509700;Hospital;0;0;1;7;8
3509700;Outros;0;0;3;0;3
3509700;Pronto Atendimento;0;0;0;0;0
3509700;Unidade Básica de Saúde;0;0;14;0;14
3509700;Unidade de Saúde Mental ;0;0;1;0;1
3509700;Unidade Móvel;0;0;3;0;3
3509700;Vigilância em Saúde;0;0;1;0;1
3509809;Clínica;0;0;0;0;0
3509809;Consultório Isolado;0;0;0;0;0
3509809;Diagnose e Terapia;0;0;0;0;0
3509809;Hospital;0;0;0;0;0
3509809;Outros;0;0;1;0;1
3509809;Pronto Atendimento;0;0;0;0;0
3509809;Unidade Básica de Saúde;0;0;3;0;3
3509809;Unidade de Saúde Mental ;0;0;0;0;0
3509809;Unidade Móvel;0;0;0;0;0
3509809;Vigilância em Saúde;0;0;0;0;0
3509908;Clínica;0;0;0;1;1
3509908;Consultório Isolado;0;0;0;1;1
3509908;Diagnose e Terapia;0;0;0;0;0
3509908;Hospital;0;0;0;0;0
3509908;Outros;0;0;1;0;1
3509908;Pronto Atendimento;0;0;0;0;0
3509908;Unidade Básica de Saúde;0;0;6;0;6
3509908;Unidade de Saúde Mental ;0;0;0;0;0
3509908;Unidade Móvel;0;0;0;0;0
3509908;Vigilância em Saúde;0;0;0;0;0
3509957;Clínica;0;0;0;0;0
3509957;Consultório Isolado;0;0;0;0;0
3509957;Diagnose e Terapia;0;0;0;0;0
3509957;Hospital;0;0;0;0;0
3509957;Outros;0;0;1;1;2
3509957;Pronto Atendimento;0;0;0;0;0
3509957;Unidade Básica de Saúde;0;0;2;0;2
3509957;Unidade de Saúde Mental ;0;0;0;0;0
3509957;Unidade Móvel;0;0;0;0;0
3509957;Vigilância em Saúde;0;0;0;0;0
3510005;Clínica;0;0;2;3;5
3510005;Consultório Isolado;0;0;0;64;64
3510005;Diagnose e Terapia;0;0;0;14;14
3510005;Hospital;0;0;0;1;1
3510005;Outros;0;0;4;0;4
3510005;Pronto Atendimento;0;0;0;0;0
3510005;Unidade Básica de Saúde;0;0;6;0;6
3510005;Unidade de Saúde Mental ;0;0;1;0;1
3510005;Unidade Móvel;0;0;0;0;0
3510005;Vigilância em Saúde;0;0;1;0;1
3510104;Clínica;0;0;0;0;0
3510104;Consultório Isolado;0;0;0;1;1
3510104;Diagnose e Terapia;0;0;0;0;0
3510104;Hospital;0;0;0;0;0
3510104;Outros;0;0;1;0;1
3510104;Pronto Atendimento;0;0;0;0;0
3510104;Unidade Básica de Saúde;0;0;1;0;1
3510104;Unidade de Saúde Mental ;0;0;0;0;0
3510104;Unidade Móvel;0;0;0;0;0
3510104;Vigilância em Saúde;0;0;0;0;0
3510153;Clínica;0;0;0;0;0
3510153;Consultório Isolado;0;0;0;0;0
3510153;Diagnose e Terapia;0;0;0;0;0
3510153;Hospital;0;0;0;0;0
3510153;Outros;0;0;1;0;1
3510153;Pronto Atendimento;0;0;0;0;0
3510153;Unidade Básica de Saúde;0;0;2;0;2
3510153;Unidade de Saúde Mental ;0;0;0;0;0
3510153;Unidade Móvel;0;0;0;0;0
3510153;Vigilância em Saúde;0;0;0;0;0
3510203;Clínica;0;0;4;5;9
3510203;Consultório Isolado;0;0;0;26;26
3510203;Diagnose e Terapia;0;0;1;6;7
3510203;Hospital;0;0;0;1;1
3510203;Outros;0;0;6;0;6
3510203;Pronto Atendimento;0;0;0;0;0
3510203;Unidade Básica de Saúde;0;0;18;0;18
3510203;Unidade de Saúde Mental ;0;0;1;0;1
3510203;Unidade Móvel;0;0;0;0;0
3510203;Vigilância em Saúde;0;0;1;0;1
3510302;Clínica;0;0;1;2;3
3510302;Consultório Isolado;0;0;0;8;8
3510302;Diagnose e Terapia;0;0;0;1;1
3510302;Hospital;0;0;0;0;0
3510302;Outros;0;0;3;0;3
3510302;Pronto Atendimento;0;0;1;0;1
3510302;Unidade Básica de Saúde;2;0;4;0;6
3510302;Unidade de Saúde Mental ;0;0;1;0;1
3510302;Unidade Móvel;0;0;1;0;1
3510302;Vigilância em Saúde;0;0;1;0;1
3510401;Clínica;0;0;3;12;15
3510401;Consultório Isolado;0;0;1;132;133
3510401;Diagnose e Terapia;0;0;3;31;34
3510401;Hospital;0;0;0;2;2
3510401;Outros;0;0;1;1;2
3510401;Pronto Atendimento;0;0;1;1;2
3510401;Unidade Básica de Saúde;0;0;9;0;9
3510401;Unidade de Saúde Mental ;0;0;2;0;2
3510401;Unidade Móvel;0;0;0;0;0
3510401;Vigilância em Saúde;0;0;0;0;0
3510500;Clínica;0;0;9;54;63
3510500;Consultório Isolado;0;0;15;114;129
3510500;Diagnose e Terapia;0;0;3;27;30
3510500;Hospital;2;0;1;5;8
3510500;Outros;1;0;5;4;10
3510500;Pronto Atendimento;0;0;3;1;4
3510500;Unidade Básica de Saúde;2;0;14;0;16
3510500;Unidade de Saúde Mental ;0;0;2;0;2
3510500;Unidade Móvel;0;0;5;2;7
3510500;Vigilância em Saúde;1;0;2;0;3
3510609;Clínica;1;0;5;32;38
3510609;Consultório Isolado;0;0;0;55;55
3510609;Diagnose e Terapia;0;0;0;10;10
3510609;Hospital;1;0;0;2;3
3510609;Outros;0;0;3;0;3
3510609;Pronto Atendimento;0;0;2;0;2
3510609;Unidade Básica de Saúde;0;0;17;1;18
3510609;Unidade de Saúde Mental ;0;0;3;0;3
3510609;Unidade Móvel;0;0;9;1;10
3510609;Vigilância em Saúde;0;0;3;0;3
3510708;Clínica;0;0;0;1;1
3510708;Consultório Isolado;0;0;0;10;10
3510708;Diagnose e Terapia;0;0;1;2;3
3510708;Hospital;0;0;0;1;1
3510708;Outros;0;0;2;0;2
3510708;Pronto Atendimento;0;0;0;0;0
3510708;Unidade Básica de Saúde;0;0;6;0;6
3510708;Unidade de Saúde Mental ;0;0;0;0;0
3510708;Unidade Móvel;0;0;1;0;1
3510708;Vigilância em Saúde;0;0;0;0;0
3510807;Clínica;2;0;2;6;10
3510807;Consultório Isolado;0;0;0;71;71
3510807;Diagnose e Terapia;0;0;2;12;14
3510807;Hospital;1;0;0;1;2
3510807;Outros;0;0;2;2;4
3510807;Pronto Atendimento;0;0;1;0;1
3510807;Unidade Básica de Saúde;1;0;7;0;8
3510807;Unidade de Saúde Mental ;1;0;1;0;2
3510807;Unidade Móvel;0;0;1;0;1
3510807;Vigilância em Saúde;0;0;1;0;1
3510906;Clínica;0;0;1;0;1
3510906;Consultório Isolado;0;0;0;0;0
3510906;Diagnose e Terapia;0;0;0;0;0
3510906;Hospital;0;0;0;0;0
3510906;Outros;0;0;2;0;2
3510906;Pronto Atendimento;0;0;0;0;0
3510906;Unidade Básica de Saúde;0;0;2;0;2
3510906;Unidade de Saúde Mental ;0;0;0;0;0
3510906;Unidade Móvel;0;0;0;0;0
3510906;Vigilância em Saúde;0;0;0;0;0
3511003;Clínica;0;0;1;4;5
3511003;Consultório Isolado;0;0;0;30;30
3511003;Diagnose e Terapia;0;0;1;2;3
3511003;Hospital;0;0;0;1;1
3511003;Outros;0;0;2;0;2
3511003;Pronto Atendimento;0;0;0;0;0
3511003;Unidade Básica de Saúde;0;0;6;0;6
3511003;Unidade de Saúde Mental ;0;0;0;0;0
3511003;Unidade Móvel;0;0;0;0;0
3511003;Vigilância em Saúde;0;0;0;0;0
3511102;Clínica;1;0;7;235;243
3511102;Consultório Isolado;0;0;0;372;372
3511102;Diagnose e Terapia;0;0;1;26;27
3511102;Hospital;0;0;0;11;11
3511102;Outros;0;0;7;4;11
3511102;Pronto Atendimento;0;0;1;0;1
3511102;Unidade Básica de Saúde;0;0;27;0;27
3511102;Unidade de Saúde Mental ;0;0;2;0;2
3511102;Unidade Móvel;0;0;11;0;11
3511102;Vigilância em Saúde;0;0;2;0;2
3511201;Clínica;0;0;1;0;1
3511201;Consultório Isolado;0;0;0;9;9
3511201;Diagnose e Terapia;0;0;0;0;0
3511201;Hospital;0;0;0;0;0
3511201;Outros;0;0;1;0;1
3511201;Pronto Atendimento;0;0;0;0;0
3511201;Unidade Básica de Saúde;0;0;2;0;2
3511201;Unidade de Saúde Mental ;0;0;0;0;0
3511201;Unidade Móvel;0;0;1;0;1
3511201;Vigilância em Saúde;0;0;0;0;0
3511300;Clínica;0;0;1;7;8
3511300;Consultório Isolado;0;0;0;8;8
3511300;Diagnose e Terapia;0;0;0;1;1
3511300;Hospital;0;0;0;0;0
3511300;Outros;0;0;1;0;1
3511300;Pronto Atendimento;0;0;0;0;0
3511300;Unidade Básica de Saúde;0;0;3;3;6
3511300;Unidade de Saúde Mental ;0;0;0;0;0
3511300;Unidade Móvel;0;0;1;0;1
3511300;Vigilância em Saúde;0;0;1;0;1
3511409;Clínica;0;0;0;2;2
3511409;Consultório Isolado;0;0;0;10;10
3511409;Diagnose e Terapia;0;0;0;5;5
3511409;Hospital;0;0;0;1;1
3511409;Outros;0;0;1;0;1
3511409;Pronto Atendimento;0;0;0;0;0
3511409;Unidade Básica de Saúde;3;0;6;4;13
3511409;Unidade de Saúde Mental ;0;0;0;0;0
3511409;Unidade Móvel;0;0;1;0;1
3511409;Vigilância em Saúde;0;0;0;0;0
3511508;Clínica;0;0;7;25;32
3511508;Consultório Isolado;0;0;0;130;130
3511508;Diagnose e Terapia;0;0;1;8;9
3511508;Hospital;0;0;0;1;1
3511508;Outros;0;0;3;1;4
3511508;Pronto Atendimento;0;0;0;0;0
3511508;Unidade Básica de Saúde;0;0;10;0;10
3511508;Unidade de Saúde Mental ;0;0;1;0;1
3511508;Unidade Móvel;0;0;0;0;0
3511508;Vigilância em Saúde;0;0;2;0;2
3511607;Clínica;0;0;2;1;3
3511607;Consultório Isolado;0;0;0;8;8
3511607;Diagnose e Terapia;0;0;0;3;3
3511607;Hospital;0;0;0;1;1
3511607;Outros;0;0;2;0;2
3511607;Pronto Atendimento;0;0;0;0;0
3511607;Unidade Básica de Saúde;0;0;4;0;4
3511607;Unidade de Saúde Mental ;0;0;1;0;1
3511607;Unidade Móvel;0;0;0;0;0
3511607;Vigilância em Saúde;0;0;1;0;1
3511706;Clínica;0;0;1;8;9
3511706;Consultório Isolado;0;0;0;15;15
3511706;Diagnose e Terapia;0;0;0;3;3
3511706;Hospital;0;0;0;1;1
3511706;Outros;0;0;1;0;1
3511706;Pronto Atendimento;0;0;0;0;0
3511706;Unidade Básica de Saúde;0;0;6;0;6
3511706;Unidade de Saúde Mental ;0;0;1;0;1
3511706;Unidade Móvel;0;0;0;0;0
3511706;Vigilância em Saúde;0;0;0;0;0
3511904;Clínica;0;0;0;0;0
3511904;Consultório Isolado;0;0;1;4;5
3511904;Diagnose e Terapia;0;0;0;1;1
3511904;Hospital;0;0;0;1;1
3511904;Outros;0;0;2;1;3
3511904;Pronto Atendimento;0;0;0;0;0
3511904;Unidade Básica de Saúde;0;0;1;0;1
3511904;Unidade de Saúde Mental ;0;0;0;0;0
3511904;Unidade Móvel;0;0;0;0;0
3511904;Vigilância em Saúde;0;0;1;0;1
3512001;Clínica;0;0;1;10;11
3512001;Consultório Isolado;0;0;0;41;41
3512001;Diagnose e Terapia;0;0;0;2;2
3512001;Hospital;0;0;0;1;1
3512001;Outros;0;0;1;0;1
3512001;Pronto Atendimento;0;0;1;0;1
3512001;Unidade Básica de Saúde;0;0;6;0;6
3512001;Unidade de Saúde Mental ;0;0;0;0;0
3512001;Unidade Móvel;0;0;1;0;1
3512001;Vigilância em Saúde;0;0;0;0;0
3512100;Clínica;0;0;0;2;2
3512100;Consultório Isolado;0;0;0;3;3
3512100;Diagnose e Terapia;0;0;1;0;1
3512100;Hospital;0;0;0;0;0
3512100;Outros;0;0;2;0;2
3512100;Pronto Atendimento;0;0;0;0;0
3512100;Unidade Básica de Saúde;0;0;4;0;4
3512100;Unidade de Saúde Mental ;0;0;0;0;0
3512100;Unidade Móvel;0;0;1;0;1
3512100;Vigilância em Saúde;0;0;0;0;0
3512209;Clínica;0;0;1;2;3
3512209;Consultório Isolado;0;0;0;30;30
3512209;Diagnose e Terapia;0;0;1;7;8
3512209;Hospital;0;0;0;1;1
3512209;Outros;0;0;2;0;2
3512209;Pronto Atendimento;0;0;0;1;1
3512209;Unidade Básica de Saúde;0;0;9;1;10
3512209;Unidade de Saúde Mental ;0;0;1;0;1
3512209;Unidade Móvel;0;0;2;0;2
3512209;Vigilância em Saúde;0;0;2;0;2
3512308;Clínica;0;0;2;1;3
3512308;Consultório Isolado;0;0;1;27;28
3512308;Diagnose e Terapia;0;0;1;8;9
3512308;Hospital;0;0;2;2;4
3512308;Outros;0;0;3;0;3
3512308;Pronto Atendimento;0;0;0;0;0
3512308;Unidade Básica de Saúde;0;0;5;0;5
3512308;Unidade de Saúde Mental ;0;0;0;0;0
3512308;Unidade Móvel;0;0;0;0;0
3512308;Vigilância em Saúde;0;0;2;0;2
3512407;Clínica;0;0;3;7;10
3512407;Consultório Isolado;0;0;0;22;22
3512407;Diagnose e Terapia;0;0;1;3;4
3512407;Hospital;0;0;0;0;0
3512407;Outros;0;0;3;0;3
3512407;Pronto Atendimento;0;0;1;0;1
3512407;Unidade Básica de Saúde;0;0;7;0;7
3512407;Unidade de Saúde Mental ;0;0;1;0;1
3512407;Unidade Móvel;0;0;1;0;1
3512407;Vigilância em Saúde;0;0;0;0;0
3512506;Clínica;0;0;0;0;0
3512506;Consultório Isolado;0;0;0;0;0
3512506;Diagnose e Terapia;0;0;0;0;0
3512506;Hospital;0;0;0;0;0
3512506;Outros;0;0;1;0;1
3512506;Pronto Atendimento;0;0;0;0;0
3512506;Unidade Básica de Saúde;0;0;1;0;1
3512506;Unidade de Saúde Mental ;0;0;0;0;0
3512506;Unidade Móvel;0;0;0;0;0
3512506;Vigilância em Saúde;0;0;1;0;1
3512605;Clínica;0;0;0;0;0
3512605;Consultório Isolado;0;0;0;0;0
3512605;Diagnose e Terapia;0;0;0;0;0
3512605;Hospital;0;0;0;0;0
3512605;Outros;0;0;2;0;2
3512605;Pronto Atendimento;0;0;0;0;0
3512605;Unidade Básica de Saúde;0;0;4;0;4
3512605;Unidade de Saúde Mental ;0;0;0;0;0
3512605;Unidade Móvel;0;0;0;0;0
3512605;Vigilância em Saúde;0;0;1;0;1
3512704;Clínica;0;0;0;0;0
3512704;Consultório Isolado;0;0;0;1;1
3512704;Diagnose e Terapia;0;0;0;0;0
3512704;Hospital;0;0;0;0;0
3512704;Outros;0;0;1;0;1
3512704;Pronto Atendimento;0;0;0;0;0
3512704;Unidade Básica de Saúde;0;0;2;0;2
3512704;Unidade de Saúde Mental ;0;0;0;0;0
3512704;Unidade Móvel;0;0;3;0;3
3512704;Vigilância em Saúde;0;0;0;0;0
3512803;Clínica;0;0;6;15;21
3512803;Consultório Isolado;0;0;0;58;58
3512803;Diagnose e Terapia;0;0;1;12;13
3512803;Hospital;0;0;0;2;2
3512803;Outros;0;0;5;2;7
3512803;Pronto Atendimento;0;0;1;0;1
3512803;Unidade Básica de Saúde;0;0;9;0;9
3512803;Unidade de Saúde Mental ;0;0;2;0;2
3512803;Unidade Móvel;0;0;0;0;0
3512803;Vigilância em Saúde;0;0;2;0;2
3512902;Clínica;0;0;0;0;0
3512902;Consultório Isolado;0;0;0;0;0
3512902;Diagnose e Terapia;0;0;0;1;1
3512902;Hospital;0;0;0;0;0
3512902;Outros;0;0;1;0;1
3512902;Pronto Atendimento;0;0;0;0;0
3512902;Unidade Básica de Saúde;0;0;4;0;4
3512902;Unidade de Saúde Mental ;0;0;0;0;0
3512902;Unidade Móvel;0;0;0;0;0
3512902;Vigilância em Saúde;0;0;0;0;0
3513009;Clínica;0;0;10;32;42
3513009;Consultório Isolado;0;0;2;108;110
3513009;Diagnose e Terapia;0;0;0;18;18
3513009;Hospital;1;0;1;5;7
3513009;Outros;0;0;5;1;6
3513009;Pronto Atendimento;0;0;5;0;5
3513009;Unidade Básica de Saúde;0;0;26;0;26
3513009;Unidade de Saúde Mental ;0;0;3;0;3
3513009;Unidade Móvel;0;0;5;0;5
3513009;Vigilância em Saúde;0;0;4;0;4
3513108;Clínica;0;0;6;2;8
3513108;Consultório Isolado;0;0;0;62;62
3513108;Diagnose e Terapia;0;0;0;5;5
3513108;Hospital;0;0;0;1;1
3513108;Outros;0;0;1;13;14
3513108;Pronto Atendimento;0;0;1;0;1
3513108;Unidade Básica de Saúde;0;0;6;0;6
3513108;Unidade de Saúde Mental ;0;0;0;0;0
3513108;Unidade Móvel;0;0;1;0;1
3513108;Vigilância em Saúde;0;0;4;0;4
3513207;Clínica;0;0;2;0;2
3513207;Consultório Isolado;0;0;1;5;6
3513207;Diagnose e Terapia;0;0;1;1;2
3513207;Hospital;0;0;0;0;0
3513207;Outros;0;0;1;0;1
3513207;Pronto Atendimento;0;0;0;0;0
3513207;Unidade Básica de Saúde;0;0;3;0;3
3513207;Unidade de Saúde Mental ;0;0;0;0;0
3513207;Unidade Móvel;0;0;0;0;0
3513207;Vigilância em Saúde;0;0;0;0;0
3513306;Clínica;0;0;0;0;0
3513306;Consultório Isolado;0;0;0;1;1
3513306;Diagnose e Terapia;0;0;0;0;0
3513306;Hospital;0;0;0;0;0
3513306;Outros;0;0;1;0;1
3513306;Pronto Atendimento;0;0;0;0;0
3513306;Unidade Básica de Saúde;0;0;3;0;3
3513306;Unidade de Saúde Mental ;0;0;0;0;0
3513306;Unidade Móvel;0;0;0;0;0
3513306;Vigilância em Saúde;0;0;0;0;0
3513405;Clínica;0;0;10;62;72
3513405;Consultório Isolado;0;0;1;183;184
3513405;Diagnose e Terapia;0;0;1;25;26
3513405;Hospital;0;0;1;3;4
3513405;Outros;0;0;5;3;8
3513405;Pronto Atendimento;0;0;0;0;0
3513405;Unidade Básica de Saúde;0;0;18;1;19
3513405;Unidade de Saúde Mental ;0;0;1;0;1
3513405;Unidade Móvel;0;0;2;1;3
3513405;Vigilância em Saúde;0;0;1;0;1
3513504;Clínica;0;0;10;15;25
3513504;Consultório Isolado;0;0;0;129;129
3513504;Diagnose e Terapia;0;0;0;27;27
3513504;Hospital;0;0;0;2;2
3513504;Outros;0;0;3;1;4
3513504;Pronto Atendimento;0;0;4;0;4
3513504;Unidade Básica de Saúde;0;0;18;0;18
3513504;Unidade de Saúde Mental ;0;0;2;0;2
3513504;Unidade Móvel;0;0;5;0;5
3513504;Vigilância em Saúde;0;0;1;0;1
3513603;Clínica;0;0;1;2;3
3513603;Consultório Isolado;0;0;1;9;10
3513603;Diagnose e Terapia;0;0;1;2;3
3513603;Hospital;0;0;0;1;1
3513603;Outros;0;0;3;0;3
3513603;Pronto Atendimento;0;0;0;0;0
3513603;Unidade Básica de Saúde;0;0;6;0;6
3513603;Unidade de Saúde Mental ;0;0;1;0;1
3513603;Unidade Móvel;0;0;1;0;1
3513603;Vigilância em Saúde;0;0;0;0;0
3513702;Clínica;0;0;3;12;15
3513702;Consultório Isolado;0;0;0;113;113
3513702;Diagnose e Terapia;0;0;0;4;4
3513702;Hospital;0;0;0;1;1
3513702;Outros;0;0;3;0;3
3513702;Pronto Atendimento;0;0;1;0;1
3513702;Unidade Básica de Saúde;0;0;12;0;12
3513702;Unidade de Saúde Mental ;0;0;1;0;1
3513702;Unidade Móvel;0;0;0;0;0
3513702;Vigilância em Saúde;0;0;1;0;1
3513801;Clínica;1;0;1;56;58
3513801;Consultório Isolado;1;0;0;91;92
3513801;Diagnose e Terapia;0;0;0;18;18
3513801;Hospital;1;0;3;2;6
3513801;Outros;0;0;5;0;5
3513801;Pronto Atendimento;0;0;3;3;6
3513801;Unidade Básica de Saúde;0;0;20;0;20
3513801;Unidade de Saúde Mental ;0;0;5;0;5
3513801;Unidade Móvel;0;0;26;0;26
3513801;Vigilância em Saúde;0;0;2;0;2
3513850;Clínica;0;0;0;0;0
3513850;Consultório Isolado;0;0;0;0;0
3513850;Diagnose e Terapia;0;0;0;0;0
3513850;Hospital;0;0;0;0;0
3513850;Outros;0;0;2;0;2
3513850;Pronto Atendimento;0;0;0;0;0
3513850;Unidade Básica de Saúde;0;0;1;0;1
3513850;Unidade de Saúde Mental ;0;0;0;0;0
3513850;Unidade Móvel;0;0;0;0;0
3513850;Vigilância em Saúde;0;0;0;0;0
3513900;Clínica;0;0;0;7;7
3513900;Consultório Isolado;0;0;0;15;15
3513900;Diagnose e Terapia;0;0;0;1;1
3513900;Hospital;0;0;0;1;1
3513900;Outros;0;0;1;2;3
3513900;Pronto Atendimento;0;0;0;0;0
3513900;Unidade Básica de Saúde;0;0;8;0;8
3513900;Unidade de Saúde Mental ;0;0;0;0;0
3513900;Unidade Móvel;0;0;1;1;2
3513900;Vigilância em Saúde;0;0;0;0;0
3514007;Clínica;0;0;0;0;0
3514007;Consultório Isolado;0;0;0;3;3
3514007;Diagnose e Terapia;0;0;0;3;3
3514007;Hospital;0;0;0;0;0
3514007;Outros;0;0;1;3;4
3514007;Pronto Atendimento;0;0;0;0;0
3514007;Unidade Básica de Saúde;0;0;1;0;1
3514007;Unidade de Saúde Mental ;0;0;0;0;0
3514007;Unidade Móvel;0;0;0;0;0
3514007;Vigilância em Saúde;0;0;0;0;0
3514106;Clínica;0;0;1;6;7
3514106;Consultório Isolado;0;0;1;42;43
3514106;Diagnose e Terapia;0;0;0;5;5
3514106;Hospital;0;0;0;1;1
3514106;Outros;0;0;3;0;3
3514106;Pronto Atendimento;0;0;0;0;0
3514106;Unidade Básica de Saúde;0;0;5;0;5
3514106;Unidade de Saúde Mental ;0;0;1;0;1
3514106;Unidade Móvel;0;0;0;0;0
3514106;Vigilância em Saúde;0;0;0;0;0
3514205;Clínica;0;0;0;0;0
3514205;Consultório Isolado;0;0;0;1;1
3514205;Diagnose e Terapia;0;0;0;0;0
3514205;Hospital;0;0;0;0;0
3514205;Outros;0;0;1;0;1
3514205;Pronto Atendimento;0;0;0;0;0
3514205;Unidade Básica de Saúde;0;0;2;0;2
3514205;Unidade de Saúde Mental ;0;0;0;0;0
3514205;Unidade Móvel;0;0;0;0;0
3514205;Vigilância em Saúde;0;0;0;0;0
3514304;Clínica;0;0;0;3;3
3514304;Consultório Isolado;0;0;0;8;8
3514304;Diagnose e Terapia;0;0;0;1;1
3514304;Hospital;0;0;1;1;2
3514304;Outros;0;0;2;0;2
3514304;Pronto Atendimento;0;0;1;0;1
3514304;Unidade Básica de Saúde;0;0;3;0;3
3514304;Unidade de Saúde Mental ;0;0;0;0;0
3514304;Unidade Móvel;0;0;0;0;0
3514304;Vigilância em Saúde;0;0;0;0;0
3514403;Clínica;1;0;2;14;17
3514403;Consultório Isolado;0;0;1;235;236
3514403;Diagnose e Terapia;0;1;3;7;11
3514403;Hospital;0;0;0;1;1
3514403;Outros;0;0;1;2;3
3514403;Pronto Atendimento;0;0;2;1;3
3514403;Unidade Básica de Saúde;1;0;11;1;13
3514403;Unidade de Saúde Mental ;0;0;1;0;1
3514403;Unidade Móvel;0;0;0;0;0
3514403;Vigilância em Saúde;0;0;1;0;1
3514502;Clínica;0;0;0;1;1
3514502;Consultório Isolado;0;0;0;40;40
3514502;Diagnose e Terapia;0;0;0;6;6
3514502;Hospital;0;0;0;1;1
3514502;Outros;0;0;1;0;1
3514502;Pronto Atendimento;0;0;0;0;0
3514502;Unidade Básica de Saúde;0;0;6;0;6
3514502;Unidade de Saúde Mental ;0;0;1;0;1
3514502;Unidade Móvel;0;0;3;0;3
3514502;Vigilância em Saúde;0;0;0;0;0
3514601;Clínica;0;0;0;0;0
3514601;Consultório Isolado;0;0;0;0;0
3514601;Diagnose e Terapia;0;0;0;0;0
3514601;Hospital;0;0;0;0;0
3514601;Outros;0;0;2;0;2
3514601;Pronto Atendimento;0;0;0;0;0
3514601;Unidade Básica de Saúde;0;0;2;0;2
3514601;Unidade de Saúde Mental ;0;0;0;0;0
3514601;Unidade Móvel;0;0;1;0;1
3514601;Vigilância em Saúde;0;0;0;0;0
3514700;Clínica;0;0;0;0;0
3514700;Consultório Isolado;0;0;0;1;1
3514700;Diagnose e Terapia;0;0;0;1;1
3514700;Hospital;0;0;0;0;0
3514700;Outros;0;0;2;0;2
3514700;Pronto Atendimento;0;0;1;0;1
3514700;Unidade Básica de Saúde;0;0;2;0;2
3514700;Unidade de Saúde Mental ;0;0;0;0;0
3514700;Unidade Móvel;0;0;0;0;0
3514700;Vigilância em Saúde;0;0;0;0;0
3514809;Clínica;0;0;1;2;3
3514809;Consultório Isolado;0;0;0;1;1
3514809;Diagnose e Terapia;0;0;0;0;0
3514809;Hospital;0;0;0;0;0
3514809;Outros;0;0;3;0;3
3514809;Pronto Atendimento;0;0;1;0;1
3514809;Unidade Básica de Saúde;0;0;10;0;10
3514809;Unidade de Saúde Mental ;0;0;1;0;1
3514809;Unidade Móvel;0;0;0;0;0
3514809;Vigilância em Saúde;0;0;0;0;0
3514908;Clínica;0;0;1;1;2
3514908;Consultório Isolado;0;0;0;3;3
3514908;Diagnose e Terapia;0;0;0;2;2
3514908;Hospital;0;0;0;0;0
3514908;Outros;0;0;1;0;1
3514908;Pronto Atendimento;0;0;0;0;0
3514908;Unidade Básica de Saúde;0;0;5;0;5
3514908;Unidade de Saúde Mental ;0;0;1;0;1
3514908;Unidade Móvel;0;0;0;0;0
3514908;Vigilância em Saúde;0;0;0;0;0
3514924;Clínica;0;0;0;0;0
3514924;Consultório Isolado;0;0;0;1;1
3514924;Diagnose e Terapia;0;0;0;0;0
3514924;Hospital;0;0;0;0;0
3514924;Outros;0;0;1;0;1
3514924;Pronto Atendimento;0;0;0;0;0
3514924;Unidade Básica de Saúde;0;0;1;0;1
3514924;Unidade de Saúde Mental ;0;0;0;0;0
3514924;Unidade Móvel;0;0;1;0;1
3514924;Vigilância em Saúde;0;0;0;0;0
3514957;Clínica;0;0;0;0;0
3514957;Consultório Isolado;0;0;0;0;0
3514957;Diagnose e Terapia;0;0;0;1;1
3514957;Hospital;0;0;0;0;0
3514957;Outros;0;0;1;0;1
3514957;Pronto Atendimento;0;0;0;0;0
3514957;Unidade Básica de Saúde;0;0;1;0;1
3514957;Unidade de Saúde Mental ;0;0;0;0;0
3514957;Unidade Móvel;0;0;0;0;0
3514957;Vigilância em Saúde;0;0;0;0;0
3515004;Clínica;0;0;5;8;13
3515004;Consultório Isolado;0;0;0;85;85
3515004;Diagnose e Terapia;0;0;0;1;1
3515004;Hospital;0;0;4;2;6
3515004;Outros;0;0;4;0;4
3515004;Pronto Atendimento;0;0;1;0;1
3515004;Unidade Básica de Saúde;0;0;18;0;18
3515004;Unidade de Saúde Mental ;0;0;3;0;3
3515004;Unidade Móvel;0;0;4;0;4
3515004;Vigilância em Saúde;0;0;2;0;2
3515103;Clínica;0;0;1;8;9
3515103;Consultório Isolado;0;0;1;8;9
3515103;Diagnose e Terapia;0;0;0;2;2
3515103;Hospital;0;0;0;0;0
3515103;Outros;0;0;4;3;7
3515103;Pronto Atendimento;0;0;1;0;1
3515103;Unidade Básica de Saúde;0;0;13;0;13
3515103;Unidade de Saúde Mental ;0;0;1;0;1
3515103;Unidade Móvel;0;0;2;0;2
3515103;Vigilância em Saúde;0;0;1;0;1
3515129;Clínica;0;0;0;0;0
3515129;Consultório Isolado;0;0;0;1;1
3515129;Diagnose e Terapia;0;0;0;0;0
3515129;Hospital;0;0;0;0;0
3515129;Outros;0;0;1;0;1
3515129;Pronto Atendimento;0;0;0;0;0
3515129;Unidade Básica de Saúde;0;0;1;0;1
3515129;Unidade de Saúde Mental ;0;0;0;0;0
3515129;Unidade Móvel;0;0;0;0;0
3515129;Vigilância em Saúde;0;0;0;0;0
3515152;Clínica;0;0;2;5;7
3515152;Consultório Isolado;0;0;0;15;15
3515152;Diagnose e Terapia;0;0;1;1;2
3515152;Hospital;0;0;0;0;0
3515152;Outros;0;0;4;1;5
3515152;Pronto Atendimento;0;0;1;0;1
3515152;Unidade Básica de Saúde;0;0;5;0;5
3515152;Unidade de Saúde Mental ;0;0;1;0;1
3515152;Unidade Móvel;0;0;0;0;0
3515152;Vigilância em Saúde;0;0;0;0;0
3515186;Clínica;0;0;0;23;23
3515186;Consultório Isolado;0;0;0;138;138
3515186;Diagnose e Terapia;0;0;2;5;7
3515186;Hospital;0;0;0;3;3
3515186;Outros;0;0;3;0;3
3515186;Pronto Atendimento;0;0;0;0;0
3515186;Unidade Básica de Saúde;0;0;7;0;7
3515186;Unidade de Saúde Mental ;0;0;2;0;2
3515186;Unidade Móvel;0;0;1;0;1
3515186;Vigilância em Saúde;0;0;2;0;2
3515194;Clínica;0;0;0;0;0
3515194;Consultório Isolado;0;0;0;0;0
3515194;Diagnose e Terapia;0;0;1;1;2
3515194;Hospital;0;0;0;0;0
3515194;Outros;0;0;1;0;1
3515194;Pronto Atendimento;0;0;0;0;0
3515194;Unidade Básica de Saúde;0;0;2;0;2
3515194;Unidade de Saúde Mental ;0;0;0;0;0
3515194;Unidade Móvel;0;0;0;0;0
3515194;Vigilância em Saúde;0;0;0;0;0
3515202;Clínica;0;0;0;4;4
3515202;Consultório Isolado;0;0;0;22;22
3515202;Diagnose e Terapia;0;0;0;1;1
3515202;Hospital;0;0;0;1;1
3515202;Outros;0;0;2;0;2
3515202;Pronto Atendimento;0;0;0;0;0
3515202;Unidade Básica de Saúde;0;0;3;0;3
3515202;Unidade de Saúde Mental ;0;0;0;0;0
3515202;Unidade Móvel;0;0;1;0;1
3515202;Vigilância em Saúde;0;0;0;0;0
3515301;Clínica;0;0;0;0;0
3515301;Consultório Isolado;0;0;0;0;0
3515301;Diagnose e Terapia;0;0;0;0;0
3515301;Hospital;0;0;0;0;0
3515301;Outros;0;0;1;0;1
3515301;Pronto Atendimento;0;0;0;0;0
3515301;Unidade Básica de Saúde;0;0;1;0;1
3515301;Unidade de Saúde Mental ;0;0;0;0;0
3515301;Unidade Móvel;0;0;0;0;0
3515301;Vigilância em Saúde;0;0;0;0;0
3515350;Clínica;0;0;1;1;2
3515350;Consultório Isolado;0;0;0;3;3
3515350;Diagnose e Terapia;0;0;0;1;1
3515350;Hospital;0;0;0;0;0
3515350;Outros;0;0;2;0;2
3515350;Pronto Atendimento;0;0;0;0;0
3515350;Unidade Básica de Saúde;0;0;5;0;5
3515350;Unidade de Saúde Mental ;0;0;0;0;0
3515350;Unidade Móvel;0;0;1;0;1
3515350;Vigilância em Saúde;0;0;1;0;1
3515400;Clínica;0;0;0;3;3
3515400;Consultório Isolado;0;0;1;25;26
3515400;Diagnose e Terapia;0;0;0;5;5
3515400;Hospital;0;0;0;1;1
3515400;Outros;0;0;1;1;2
3515400;Pronto Atendimento;0;0;0;0;0
3515400;Unidade Básica de Saúde;0;0;4;0;4
3515400;Unidade de Saúde Mental ;0;0;0;0;0
3515400;Unidade Móvel;0;0;1;0;1
3515400;Vigilância em Saúde;0;0;2;0;2
3515509;Clínica;2;0;8;184;194
3515509;Consultório Isolado;0;0;0;271;271
3515509;Diagnose e Terapia;0;0;1;28;29
3515509;Hospital;0;0;0;3;3
3515509;Outros;0;0;6;24;30
3515509;Pronto Atendimento;0;0;1;0;1
3515509;Unidade Básica de Saúde;0;0;22;0;22
3515509;Unidade de Saúde Mental ;0;0;2;0;2
3515509;Unidade Móvel;0;0;5;0;5
3515509;Vigilância em Saúde;0;0;3;0;3
3515608;Clínica;0;0;2;1;3
3515608;Consultório Isolado;0;0;0;4;4
3515608;Diagnose e Terapia;0;0;0;2;2
3515608;Hospital;0;0;0;0;0
3515608;Outros;0;0;1;0;1
3515608;Pronto Atendimento;0;0;1;0;1
3515608;Unidade Básica de Saúde;0;0;2;0;2
3515608;Unidade de Saúde Mental ;0;0;0;0;0
3515608;Unidade Móvel;0;0;0;0;0
3515608;Vigilância em Saúde;0;0;0;0;0
3515657;Clínica;0;0;0;0;0
3515657;Consultório Isolado;0;0;0;0;0
3515657;Diagnose e Terapia;0;0;0;0;0
3515657;Hospital;0;0;0;0;0
3515657;Outros;0;0;2;0;2
3515657;Pronto Atendimento;0;0;0;0;0
3515657;Unidade Básica de Saúde;0;0;1;0;1
3515657;Unidade de Saúde Mental ;0;0;0;0;0
3515657;Unidade Móvel;0;0;0;0;0
3515657;Vigilância em Saúde;0;0;0;0;0
3515707;Clínica;0;0;11;6;17
3515707;Consultório Isolado;0;0;1;18;19
3515707;Diagnose e Terapia;0;0;0;8;8
3515707;Hospital;1;0;1;0;2
3515707;Outros;0;0;5;0;5
3515707;Pronto Atendimento;0;0;0;0;0
3515707;Unidade Básica de Saúde;0;0;13;0;13
3515707;Unidade de Saúde Mental ;0;0;1;0;1
3515707;Unidade Móvel;0;0;8;0;8
3515707;Vigilância em Saúde;0;0;2;0;2
3515806;Clínica;0;0;1;0;1
3515806;Consultório Isolado;0;0;0;0;0
3515806;Diagnose e Terapia;0;0;0;0;0
3515806;Hospital;0;0;0;0;0
3515806;Outros;0;0;2;0;2
3515806;Pronto Atendimento;0;0;0;0;0
3515806;Unidade Básica de Saúde;0;0;1;0;1
3515806;Unidade de Saúde Mental ;0;0;0;0;0
3515806;Unidade Móvel;0;0;0;0;0
3515806;Vigilância em Saúde;0;0;0;0;0
3515905;Clínica;0;0;1;0;1
3515905;Consultório Isolado;0;0;0;1;1
3515905;Diagnose e Terapia;0;0;0;1;1
3515905;Hospital;0;0;0;0;0
3515905;Outros;0;0;1;0;1
3515905;Pronto Atendimento;0;0;0;0;0
3515905;Unidade Básica de Saúde;0;0;2;0;2
3515905;Unidade de Saúde Mental ;0;0;0;0;0
3515905;Unidade Móvel;0;0;0;0;0
3515905;Vigilância em Saúde;0;0;0;0;0
3516002;Clínica;0;0;0;0;0
3516002;Consultório Isolado;0;0;0;4;4
3516002;Diagnose e Terapia;0;0;1;2;3
3516002;Hospital;0;0;0;1;1
3516002;Outros;0;0;2;0;2
3516002;Pronto Atendimento;0;0;0;0;0
3516002;Unidade Básica de Saúde;1;0;5;0;6
3516002;Unidade de Saúde Mental ;0;0;1;0;1
3516002;Unidade Móvel;0;0;0;0;0
3516002;Vigilância em Saúde;0;0;0;0;0
3516101;Clínica;0;0;0;0;0
3516101;Consultório Isolado;0;0;0;0;0
3516101;Diagnose e Terapia;0;0;1;0;1
3516101;Hospital;0;0;0;0;0
3516101;Outros;0;0;3;0;3
3516101;Pronto Atendimento;0;0;0;0;0
3516101;Unidade Básica de Saúde;1;0;2;0;3
3516101;Unidade de Saúde Mental ;0;0;0;0;0
3516101;Unidade Móvel;0;0;0;0;0
3516101;Vigilância em Saúde;0;0;0;0;0
3516200;Clínica;1;0;8;86;95
3516200;Consultório Isolado;2;0;5;830;837
3516200;Diagnose e Terapia;0;0;2;32;34
3516200;Hospital;1;0;0;5;6
3516200;Outros;4;0;8;4;16
3516200;Pronto Atendimento;0;0;4;0;4
3516200;Unidade Básica de Saúde;1;0;22;0;23
3516200;Unidade de Saúde Mental ;0;0;4;0;4
3516200;Unidade Móvel;1;0;4;2;7
3516200;Vigilância em Saúde;0;0;5;0;5
3516309;Clínica;0;0;5;8;13
3516309;Consultório Isolado;0;0;0;42;42
3516309;Diagnose e Terapia;0;0;1;4;5
3516309;Hospital;1;0;0;1;2
3516309;Outros;0;0;3;2;5
3516309;Pronto Atendimento;0;0;1;0;1
3516309;Unidade Básica de Saúde;0;0;12;0;12
3516309;Unidade de Saúde Mental ;0;0;3;0;3
3516309;Unidade Móvel;0;0;1;0;1
3516309;Vigilância em Saúde;0;0;1;0;1
3516408;Clínica;2;0;6;10;18
3516408;Consultório Isolado;1;0;2;47;50
3516408;Diagnose e Terapia;0;0;0;11;11
3516408;Hospital;3;0;1;1;5
3516408;Outros;2;0;12;0;14
3516408;Pronto Atendimento;0;0;2;0;2
3516408;Unidade Básica de Saúde;7;0;15;0;22
3516408;Unidade de Saúde Mental ;0;0;3;0;3
3516408;Unidade Móvel;0;0;0;0;0
3516408;Vigilância em Saúde;1;0;4;0;5
3516507;Clínica;0;0;0;0;0
3516507;Consultório Isolado;0;0;0;0;0
3516507;Diagnose e Terapia;0;0;0;0;0
3516507;Hospital;0;0;0;0;0
3516507;Outros;0;0;1;1;2
3516507;Pronto Atendimento;0;0;0;0;0
3516507;Unidade Básica de Saúde;0;0;1;0;1
3516507;Unidade de Saúde Mental ;0;0;0;0;0
3516507;Unidade Móvel;0;0;0;0;0
3516507;Vigilância em Saúde;0;0;0;0;0
3516606;Clínica;0;0;0;2;2
3516606;Consultório Isolado;0;0;0;6;6
3516606;Diagnose e Terapia;0;0;0;1;1
3516606;Hospital;0;0;0;1;1
3516606;Outros;0;0;2;0;2
3516606;Pronto Atendimento;0;0;0;0;0
3516606;Unidade Básica de Saúde;0;0;2;0;2
3516606;Unidade de Saúde Mental ;0;0;0;0;0
3516606;Unidade Móvel;0;0;0;0;0
3516606;Vigilância em Saúde;0;0;0;0;0
3516705;Clínica;0;0;4;9;13
3516705;Consultório Isolado;0;0;0;48;48
3516705;Diagnose e Terapia;0;0;0;2;2
3516705;Hospital;0;0;0;5;5
3516705;Outros;0;0;5;0;5
3516705;Pronto Atendimento;0;0;1;0;1
3516705;Unidade Básica de Saúde;0;0;13;0;13
3516705;Unidade de Saúde Mental ;0;0;2;0;2
3516705;Unidade Móvel;0;0;1;0;1
3516705;Vigilância em Saúde;0;0;1;0;1
3516804;Clínica;0;0;0;0;0
3516804;Consultório Isolado;0;0;0;0;0
3516804;Diagnose e Terapia;0;0;0;0;0
3516804;Hospital;0;0;0;0;0
3516804;Outros;0;0;1;0;1
3516804;Pronto Atendimento;0;0;0;0;0
3516804;Unidade Básica de Saúde;0;0;1;0;1
3516804;Unidade de Saúde Mental ;0;0;0;0;0
3516804;Unidade Móvel;0;0;0;0;0
3516804;Vigilância em Saúde;0;0;0;0;0
3516853;Clínica;0;0;0;0;0
3516853;Consultório Isolado;0;0;0;3;3
3516853;Diagnose e Terapia;0;0;0;0;0
3516853;Hospital;0;0;0;0;0
3516853;Outros;0;0;1;0;1
3516853;Pronto Atendimento;0;0;1;0;1
3516853;Unidade Básica de Saúde;0;0;3;0;3
3516853;Unidade de Saúde Mental ;0;0;0;0;0
3516853;Unidade Móvel;0;0;0;0;0
3516853;Vigilância em Saúde;0;0;0;0;0
3516903;Clínica;0;0;1;2;3
3516903;Consultório Isolado;0;0;0;9;9
3516903;Diagnose e Terapia;0;0;1;3;4
3516903;Hospital;0;0;0;1;1
3516903;Outros;0;0;2;0;2
3516903;Pronto Atendimento;0;0;0;0;0
3516903;Unidade Básica de Saúde;0;0;5;0;5
3516903;Unidade de Saúde Mental ;0;0;0;0;0
3516903;Unidade Móvel;0;0;0;0;0
3516903;Vigilância em Saúde;0;0;1;0;1
3517000;Clínica;0;0;0;0;0
3517000;Consultório Isolado;0;0;0;14;14
3517000;Diagnose e Terapia;0;0;0;0;0
3517000;Hospital;0;0;0;1;1
3517000;Outros;0;0;2;0;2
3517000;Pronto Atendimento;0;0;0;0;0
3517000;Unidade Básica de Saúde;1;0;4;0;5
3517000;Unidade de Saúde Mental ;0;0;0;0;0
3517000;Unidade Móvel;0;0;0;0;0
3517000;Vigilância em Saúde;0;0;0;0;0
3517109;Clínica;0;0;1;0;1
3517109;Consultório Isolado;0;0;0;1;1
3517109;Diagnose e Terapia;0;0;0;0;0
3517109;Hospital;0;0;0;0;0
3517109;Outros;0;0;1;0;1
3517109;Pronto Atendimento;0;0;0;0;0
3517109;Unidade Básica de Saúde;0;0;2;0;2
3517109;Unidade de Saúde Mental ;0;0;0;0;0
3517109;Unidade Móvel;0;0;0;0;0
3517109;Vigilância em Saúde;0;0;0;0;0
3517208;Clínica;0;0;1;1;2
3517208;Consultório Isolado;0;0;0;8;8
3517208;Diagnose e Terapia;0;0;0;2;2
3517208;Hospital;0;0;0;0;0
3517208;Outros;0;0;1;0;1
3517208;Pronto Atendimento;0;0;0;0;0
3517208;Unidade Básica de Saúde;0;0;5;0;5
3517208;Unidade de Saúde Mental ;0;0;0;0;0
3517208;Unidade Móvel;0;0;0;0;0
3517208;Vigilância em Saúde;0;0;0;0;0
3517307;Clínica;0;0;0;0;0
3517307;Consultório Isolado;0;0;0;3;3
3517307;Diagnose e Terapia;0;0;0;0;0
3517307;Hospital;0;0;0;0;0
3517307;Outros;0;0;3;0;3
3517307;Pronto Atendimento;0;0;1;0;1
3517307;Unidade Básica de Saúde;0;0;2;0;2
3517307;Unidade de Saúde Mental ;0;0;0;0;0
3517307;Unidade Móvel;0;0;0;0;0
3517307;Vigilância em Saúde;0;0;0;0;0
3517406;Clínica;0;0;2;8;10
3517406;Consultório Isolado;0;0;0;73;73
3517406;Diagnose e Terapia;0;0;1;6;7
3517406;Hospital;0;0;0;1;1
3517406;Outros;0;0;3;1;4
3517406;Pronto Atendimento;0;0;1;0;1
3517406;Unidade Básica de Saúde;0;0;9;0;9
3517406;Unidade de Saúde Mental ;0;0;1;0;1
3517406;Unidade Móvel;0;0;1;0;1
3517406;Vigilância em Saúde;0;0;1;0;1
3517505;Clínica;0;0;0;5;5
3517505;Consultório Isolado;0;0;2;9;11
3517505;Diagnose e Terapia;0;0;0;2;2
3517505;Hospital;0;0;0;0;0
3517505;Outros;0;0;2;1;3
3517505;Pronto Atendimento;0;0;1;0;1
3517505;Unidade Básica de Saúde;0;0;9;0;9
3517505;Unidade de Saúde Mental ;0;0;1;0;1
3517505;Unidade Móvel;0;0;0;0;0
3517505;Vigilância em Saúde;0;0;1;0;1
3517604;Clínica;0;0;1;1;2
3517604;Consultório Isolado;0;0;0;1;1
3517604;Diagnose e Terapia;0;0;1;2;3
3517604;Hospital;0;0;1;0;1
3517604;Outros;0;0;4;1;5
3517604;Pronto Atendimento;0;0;0;0;0
3517604;Unidade Básica de Saúde;0;0;7;0;7
3517604;Unidade de Saúde Mental ;0;0;1;0;1
3517604;Unidade Móvel;0;0;1;0;1
3517604;Vigilância em Saúde;0;0;0;0;0
3517703;Clínica;0;0;4;2;6
3517703;Consultório Isolado;0;0;0;41;41
3517703;Diagnose e Terapia;0;0;0;2;2
3517703;Hospital;0;0;0;1;1
3517703;Outros;0;0;4;0;4
3517703;Pronto Atendimento;0;0;0;0;0
3517703;Unidade Básica de Saúde;0;0;7;0;7
3517703;Unidade de Saúde Mental ;0;0;1;0;1
3517703;Unidade Móvel;0;0;1;0;1
3517703;Vigilância em Saúde;0;0;1;0;1
3517802;Clínica;0;0;0;0;0
3517802;Consultório Isolado;0;0;0;10;10
3517802;Diagnose e Terapia;0;0;0;1;1
3517802;Hospital;0;0;0;1;1
3517802;Outros;0;0;2;0;2
3517802;Pronto Atendimento;0;0;0;0;0
3517802;Unidade Básica de Saúde;0;0;4;0;4
3517802;Unidade de Saúde Mental ;0;0;0;0;0
3517802;Unidade Móvel;0;0;0;0;0
3517802;Vigilância em Saúde;0;0;1;0;1
3517901;Clínica;0;0;2;0;2
3517901;Consultório Isolado;0;0;0;8;8
3517901;Diagnose e Terapia;0;0;1;2;3
3517901;Hospital;0;0;0;0;0
3517901;Outros;0;0;1;2;3
3517901;Pronto Atendimento;0;0;1;0;1
3517901;Unidade Básica de Saúde;0;0;4;0;4
3517901;Unidade de Saúde Mental ;0;0;0;0;0
3517901;Unidade Móvel;0;0;1;0;1
3517901;Vigilância em Saúde;0;0;1;0;1
3518008;Clínica;0;0;0;0;0
3518008;Consultório Isolado;0;0;0;1;1
3518008;Diagnose e Terapia;0;0;0;0;0
3518008;Hospital;0;0;0;0;0
3518008;Outros;0;0;1;0;1
3518008;Pronto Atendimento;0;0;0;0;0
3518008;Unidade Básica de Saúde;0;0;1;0;1
3518008;Unidade de Saúde Mental ;0;0;0;0;0
3518008;Unidade Móvel;0;0;0;0;0
3518008;Vigilância em Saúde;0;0;1;0;1
3518107;Clínica;0;0;0;0;0
3518107;Consultório Isolado;0;0;0;0;0
3518107;Diagnose e Terapia;0;0;0;0;0
3518107;Hospital;0;0;0;0;0
3518107;Outros;0;0;2;0;2
3518107;Pronto Atendimento;0;0;1;0;1
3518107;Unidade Básica de Saúde;0;0;3;0;3
3518107;Unidade de Saúde Mental ;0;0;0;0;0
3518107;Unidade Móvel;0;0;0;0;0
3518107;Vigilância em Saúde;0;0;0;0;0
3518206;Clínica;0;0;0;2;2
3518206;Consultório Isolado;0;0;9;44;53
3518206;Diagnose e Terapia;0;0;0;8;8
3518206;Hospital;0;0;0;1;1
3518206;Outros;0;0;2;0;2
3518206;Pronto Atendimento;0;0;0;0;0
3518206;Unidade Básica de Saúde;0;0;6;0;6
3518206;Unidade de Saúde Mental ;0;0;1;0;1
3518206;Unidade Móvel;0;0;0;0;0
3518206;Vigilância em Saúde;0;0;1;0;1
3518305;Clínica;0;0;0;2;2
3518305;Consultório Isolado;0;0;1;23;24
3518305;Diagnose e Terapia;0;0;0;4;4
3518305;Hospital;0;0;0;1;1
3518305;Outros;0;0;3;1;4
3518305;Pronto Atendimento;0;0;0;0;0
3518305;Unidade Básica de Saúde;0;0;5;0;5
3518305;Unidade de Saúde Mental ;0;0;1;0;1
3518305;Unidade Móvel;0;0;3;0;3
3518305;Vigilância em Saúde;0;0;1;0;1
3518404;Clínica;0;0;5;40;45
3518404;Consultório Isolado;1;0;1;367;369
3518404;Diagnose e Terapia;0;0;2;22;24
3518404;Hospital;0;1;1;5;7
3518404;Outros;1;0;4;26;31
3518404;Pronto Atendimento;0;0;1;0;1
3518404;Unidade Básica de Saúde;0;0;17;0;17
3518404;Unidade de Saúde Mental ;0;0;2;0;2
3518404;Unidade Móvel;0;0;5;1;6
3518404;Vigilância em Saúde;1;0;1;0;2
3518503;Clínica;0;0;1;0;1
3518503;Consultório Isolado;0;0;0;1;1
3518503;Diagnose e Terapia;0;0;0;3;3
3518503;Hospital;0;0;0;0;0
3518503;Outros;0;0;3;0;3
3518503;Pronto Atendimento;0;0;0;0;0
3518503;Unidade Básica de Saúde;2;0;4;0;6
3518503;Unidade de Saúde Mental ;0;0;1;0;1
3518503;Unidade Móvel;0;0;2;0;2
3518503;Vigilância em Saúde;0;0;2;0;2
3518602;Clínica;0;0;3;9;12
3518602;Consultório Isolado;0;0;0;30;30
3518602;Diagnose e Terapia;0;0;1;3;4
3518602;Hospital;0;0;0;1;1
3518602;Outros;0;0;2;0;2
3518602;Pronto Atendimento;0;0;0;0;0
3518602;Unidade Básica de Saúde;0;0;6;0;6
3518602;Unidade de Saúde Mental ;0;0;0;0;0
3518602;Unidade Móvel;0;0;1;0;1
3518602;Vigilância em Saúde;0;0;1;0;1
3518701;Clínica;0;0;8;47;55
3518701;Consultório Isolado;0;0;0;239;239
3518701;Diagnose e Terapia;0;0;2;47;49
3518701;Hospital;1;0;4;3;8
3518701;Outros;0;0;7;7;14
3518701;Pronto Atendimento;0;0;6;3;9
3518701;Unidade Básica de Saúde;0;0;25;0;25
3518701;Unidade de Saúde Mental ;0;0;4;0;4
3518701;Unidade Móvel;0;0;12;0;12
3518701;Vigilância em Saúde;0;0;2;0;2
3518800;Clínica;3;0;22;279;304
3518800;Consultório Isolado;0;1;0;671;672
3518800;Diagnose e Terapia;0;0;3;96;99
3518800;Hospital;2;0;4;14;20
3518800;Outros;1;0;11;9;21
3518800;Pronto Atendimento;0;0;9;1;10
3518800;Unidade Básica de Saúde;4;0;70;0;74
3518800;Unidade de Saúde Mental ;0;0;7;0;7
3518800;Unidade Móvel;0;0;23;5;28
3518800;Vigilância em Saúde;0;0;3;0;3
3518859;Clínica;0;0;1;0;1
3518859;Consultório Isolado;0;0;0;1;1
3518859;Diagnose e Terapia;0;0;0;1;1
3518859;Hospital;0;0;0;0;0
3518859;Outros;0;0;3;0;3
3518859;Pronto Atendimento;0;0;1;0;1
3518859;Unidade Básica de Saúde;0;0;3;0;3
3518859;Unidade de Saúde Mental ;0;0;0;0;0
3518859;Unidade Móvel;0;0;1;0;1
3518859;Vigilância em Saúde;0;0;0;0;0
3518909;Clínica;0;0;0;0;0
3518909;Consultório Isolado;0;0;0;0;0
3518909;Diagnose e Terapia;0;0;0;0;0
3518909;Hospital;0;0;0;0;0
3518909;Outros;0;0;1;0;1
3518909;Pronto Atendimento;0;0;0;0;0
3518909;Unidade Básica de Saúde;0;0;2;0;2
3518909;Unidade de Saúde Mental ;0;0;0;0;0
3518909;Unidade Móvel;0;0;0;0;0
3518909;Vigilância em Saúde;0;0;0;0;0
3519006;Clínica;0;0;1;0;1
3519006;Consultório Isolado;0;0;0;4;4
3519006;Diagnose e Terapia;0;0;0;1;1
3519006;Hospital;0;0;0;1;1
3519006;Outros;0;0;3;0;3
3519006;Pronto Atendimento;0;0;0;0;0
3519006;Unidade Básica de Saúde;0;0;6;0;6
3519006;Unidade de Saúde Mental ;0;0;1;0;1
3519006;Unidade Móvel;0;0;0;0;0
3519006;Vigilância em Saúde;0;0;1;0;1
3519055;Clínica;0;0;1;5;6
3519055;Consultório Isolado;0;0;0;23;23
3519055;Diagnose e Terapia;0;0;0;0;0
3519055;Hospital;0;0;0;0;0
3519055;Outros;0;0;2;0;2
3519055;Pronto Atendimento;0;0;0;0;0
3519055;Unidade Básica de Saúde;0;0;4;0;4
3519055;Unidade de Saúde Mental ;0;0;0;0;0
3519055;Unidade Móvel;0;0;0;0;0
3519055;Vigilância em Saúde;0;0;1;0;1
3519071;Clínica;0;0;6;42;48
3519071;Consultório Isolado;0;0;0;90;90
3519071;Diagnose e Terapia;0;0;0;20;20
3519071;Hospital;0;0;2;2;4
3519071;Outros;0;0;7;4;11
3519071;Pronto Atendimento;0;0;3;0;3
3519071;Unidade Básica de Saúde;4;0;19;0;23
3519071;Unidade de Saúde Mental ;0;0;3;0;3
3519071;Unidade Móvel;0;0;12;0;12
3519071;Vigilância em Saúde;0;0;1;0;1
3519105;Clínica;0;0;0;0;0
3519105;Consultório Isolado;0;0;0;7;7
3519105;Diagnose e Terapia;0;0;0;2;2
3519105;Hospital;0;0;0;1;1
3519105;Outros;0;0;2;1;3
3519105;Pronto Atendimento;0;0;0;0;0
3519105;Unidade Básica de Saúde;0;0;5;0;5
3519105;Unidade de Saúde Mental ;0;0;1;0;1
3519105;Unidade Móvel;0;0;2;0;2
3519105;Vigilância em Saúde;0;0;0;0;0
3519204;Clínica;0;0;0;0;0
3519204;Consultório Isolado;0;0;0;3;3
3519204;Diagnose e Terapia;0;0;0;0;0
3519204;Hospital;0;0;0;0;0
3519204;Outros;0;0;1;1;2
3519204;Pronto Atendimento;0;0;1;0;1
3519204;Unidade Básica de Saúde;0;0;2;0;2
3519204;Unidade de Saúde Mental ;0;0;0;0;0
3519204;Unidade Móvel;0;0;0;0;0
3519204;Vigilância em Saúde;0;0;0;0;0
3519253;Clínica;0;0;0;0;0
3519253;Consultório Isolado;0;0;0;0;0
3519253;Diagnose e Terapia;0;0;0;0;0
3519253;Hospital;0;0;0;0;0
3519253;Outros;0;0;2;0;2
3519253;Pronto Atendimento;0;0;0;0;0
3519253;Unidade Básica de Saúde;3;0;4;0;7
3519253;Unidade de Saúde Mental ;0;0;0;0;0
3519253;Unidade Móvel;0;0;0;0;0
3519253;Vigilância em Saúde;0;0;0;0;0
3519303;Clínica;0;0;1;0;1
3519303;Consultório Isolado;0;0;0;34;34
3519303;Diagnose e Terapia;0;0;0;8;8
3519303;Hospital;0;0;1;0;1
3519303;Outros;0;0;2;0;2
3519303;Pronto Atendimento;0;0;0;0;0
3519303;Unidade Básica de Saúde;0;0;10;0;10
3519303;Unidade de Saúde Mental ;0;0;0;0;0
3519303;Unidade Móvel;0;0;0;0;0
3519303;Vigilância em Saúde;0;0;1;0;1
3519402;Clínica;0;0;1;0;1
3519402;Consultório Isolado;0;0;0;8;8
3519402;Diagnose e Terapia;0;0;0;7;7
3519402;Hospital;0;0;0;1;1
3519402;Outros;0;0;1;0;1
3519402;Pronto Atendimento;0;0;0;0;0
3519402;Unidade Básica de Saúde;0;0;4;0;4
3519402;Unidade de Saúde Mental ;0;0;0;0;0
3519402;Unidade Móvel;0;0;1;0;1
3519402;Vigilância em Saúde;0;0;0;0;0
3519501;Clínica;0;0;0;0;0
3519501;Consultório Isolado;0;0;0;1;1
3519501;Diagnose e Terapia;0;0;0;1;1
3519501;Hospital;0;0;0;0;0
3519501;Outros;0;0;2;0;2
3519501;Pronto Atendimento;0;0;0;0;0
3519501;Unidade Básica de Saúde;0;0;4;0;4
3519501;Unidade de Saúde Mental ;0;0;0;0;0
3519501;Unidade Móvel;0;0;0;0;0
3519501;Vigilância em Saúde;0;0;0;0;0
3519600;Clínica;0;0;3;6;9
3519600;Consultório Isolado;0;0;0;130;130
3519600;Diagnose e Terapia;0;0;0;13;13
3519600;Hospital;0;0;0;2;2
3519600;Outros;0;0;2;1;3
3519600;Pronto Atendimento;0;0;3;0;3
3519600;Unidade Básica de Saúde;0;0;13;0;13
3519600;Unidade de Saúde Mental ;0;0;1;0;1
3519600;Unidade Móvel;0;0;3;0;3
3519600;Vigilância em Saúde;0;0;3;0;3
3519709;Clínica;0;0;2;5;7
3519709;Consultório Isolado;0;0;1;28;29
3519709;Diagnose e Terapia;0;0;0;4;4
3519709;Hospital;0;0;2;2;4
3519709;Outros;0;0;2;4;6
3519709;Pronto Atendimento;0;0;0;0;0
3519709;Unidade Básica de Saúde;0;0;19;0;19
3519709;Unidade de Saúde Mental ;0;0;2;0;2
3519709;Unidade Móvel;0;0;1;0;1
3519709;Vigilância em Saúde;0;0;2;0;2
3519808;Clínica;0;0;1;5;6
3519808;Consultório Isolado;0;0;0;7;7
3519808;Diagnose e Terapia;0;0;1;1;2
3519808;Hospital;0;0;0;0;0
3519808;Outros;0;0;2;0;2
3519808;Pronto Atendimento;0;0;0;0;0
3519808;Unidade Básica de Saúde;1;0;3;0;4
3519808;Unidade de Saúde Mental ;0;0;0;0;0
3519808;Unidade Móvel;0;0;1;0;1
3519808;Vigilância em Saúde;0;0;0;0;0
3519907;Clínica;0;0;1;2;3
3519907;Consultório Isolado;0;0;0;7;7
3519907;Diagnose e Terapia;0;0;0;2;2
3519907;Hospital;0;0;1;0;1
3519907;Outros;0;0;2;7;9
3519907;Pronto Atendimento;0;0;0;0;0
3519907;Unidade Básica de Saúde;0;0;4;0;4
3519907;Unidade de Saúde Mental ;0;0;0;0;0
3519907;Unidade Móvel;0;0;0;0;0
3519907;Vigilância em Saúde;0;0;0;0;0
3520004;Clínica;0;0;2;1;3
3520004;Consultório Isolado;0;0;0;13;13
3520004;Diagnose e Terapia;0;0;0;2;2
3520004;Hospital;0;0;0;1;1
3520004;Outros;0;0;1;0;1
3520004;Pronto Atendimento;0;0;0;0;0
3520004;Unidade Básica de Saúde;0;0;4;0;4
3520004;Unidade de Saúde Mental ;0;0;1;0;1
3520004;Unidade Móvel;0;0;0;0;0
3520004;Vigilância em Saúde;0;0;0;0;0
3520103;Clínica;0;0;3;5;8
3520103;Consultório Isolado;0;0;0;52;52
3520103;Diagnose e Terapia;0;0;1;3;4
3520103;Hospital;0;0;0;1;1
3520103;Outros;0;0;4;0;4
3520103;Pronto Atendimento;0;0;0;0;0
3520103;Unidade Básica de Saúde;0;0;7;0;7
3520103;Unidade de Saúde Mental ;0;0;1;0;1
3520103;Unidade Móvel;0;0;1;0;1
3520103;Vigilância em Saúde;0;0;0;0;0
3520202;Clínica;0;0;1;0;1
3520202;Consultório Isolado;0;0;0;1;1
3520202;Diagnose e Terapia;0;0;0;1;1
3520202;Hospital;0;0;0;0;0
3520202;Outros;0;0;4;0;4
3520202;Pronto Atendimento;0;0;0;0;0
3520202;Unidade Básica de Saúde;0;0;5;0;5
3520202;Unidade de Saúde Mental ;0;0;0;0;0
3520202;Unidade Móvel;0;0;2;0;2
3520202;Vigilância em Saúde;0;0;0;0;0
3520301;Clínica;0;0;1;6;7
3520301;Consultório Isolado;0;0;0;9;9
3520301;Diagnose e Terapia;0;0;0;7;7
3520301;Hospital;0;0;0;0;0
3520301;Outros;0;0;1;1;2
3520301;Pronto Atendimento;0;0;0;0;0
3520301;Unidade Básica de Saúde;0;0;10;0;10
3520301;Unidade de Saúde Mental ;0;0;1;0;1
3520301;Unidade Móvel;0;0;0;0;0
3520301;Vigilância em Saúde;0;0;0;0;0
3520400;Clínica;0;0;1;1;2
3520400;Consultório Isolado;0;0;0;10;10
3520400;Diagnose e Terapia;0;0;0;3;3
3520400;Hospital;0;0;1;0;1
3520400;Outros;0;0;5;0;5
3520400;Pronto Atendimento;0;0;1;0;1
3520400;Unidade Básica de Saúde;0;0;13;1;14
3520400;Unidade de Saúde Mental ;0;0;1;0;1
3520400;Unidade Móvel;0;0;2;0;2
3520400;Vigilância em Saúde;0;0;2;0;2
3520426;Clínica;0;0;0;0;0
3520426;Consultório Isolado;0;0;0;0;0
3520426;Diagnose e Terapia;0;0;0;4;4
3520426;Hospital;0;0;0;0;0
3520426;Outros;0;0;1;0;1
3520426;Pronto Atendimento;0;0;1;0;1
3520426;Unidade Básica de Saúde;0;0;8;0;8
3520426;Unidade de Saúde Mental ;0;0;0;0;0
3520426;Unidade Móvel;0;0;0;0;0
3520426;Vigilância em Saúde;0;0;1;0;1
3520442;Clínica;0;0;4;20;24
3520442;Consultório Isolado;0;0;0;101;101
3520442;Diagnose e Terapia;0;0;0;8;8
3520442;Hospital;0;0;0;1;1
3520442;Outros;0;0;3;0;3
3520442;Pronto Atendimento;0;0;0;0;0
3520442;Unidade Básica de Saúde;0;0;14;1;15
3520442;Unidade de Saúde Mental ;0;0;2;0;2
3520442;Unidade Móvel;0;0;0;0;0
3520442;Vigilância em Saúde;0;0;0;0;0
3520509;Clínica;0;0;9;56;65
3520509;Consultório Isolado;0;0;1;423;424
3520509;Diagnose e Terapia;0;0;2;36;38
3520509;Hospital;0;0;1;5;6
3520509;Outros;0;0;5;17;22
3520509;Pronto Atendimento;0;0;1;1;2
3520509;Unidade Básica de Saúde;0;0;18;0;18
3520509;Unidade de Saúde Mental ;0;0;3;0;3
3520509;Unidade Móvel;1;0;0;3;4
3520509;Vigilância em Saúde;0;0;2;0;2
3520608;Clínica;0;0;0;0;0
3520608;Consultório Isolado;0;0;0;4;4
3520608;Diagnose e Terapia;0;0;0;0;0
3520608;Hospital;0;0;0;0;0
3520608;Outros;0;0;1;0;1
3520608;Pronto Atendimento;0;0;0;0;0
3520608;Unidade Básica de Saúde;0;0;4;0;4
3520608;Unidade de Saúde Mental ;0;0;0;0;0
3520608;Unidade Móvel;0;0;0;0;0
3520608;Vigilância em Saúde;0;0;0;0;0
3520707;Clínica;0;0;0;0;0
3520707;Consultório Isolado;0;0;0;3;3
3520707;Diagnose e Terapia;0;0;0;0;0
3520707;Hospital;0;0;0;1;1
3520707;Outros;0;0;1;0;1
3520707;Pronto Atendimento;0;0;0;0;0
3520707;Unidade Básica de Saúde;0;0;2;0;2
3520707;Unidade de Saúde Mental ;0;0;0;0;0
3520707;Unidade Móvel;0;0;0;0;0
3520707;Vigilância em Saúde;0;0;0;0;0
3520806;Clínica;0;0;0;0;0
3520806;Consultório Isolado;0;0;0;1;1
3520806;Diagnose e Terapia;0;0;0;0;0
3520806;Hospital;0;0;0;0;0
3520806;Outros;0;0;1;0;1
3520806;Pronto Atendimento;0;0;0;0;0
3520806;Unidade Básica de Saúde;0;0;1;0;1
3520806;Unidade de Saúde Mental ;0;0;0;0;0
3520806;Unidade Móvel;0;0;0;0;0
3520806;Vigilância em Saúde;0;0;0;0;0
3520905;Clínica;0;0;0;1;1
3520905;Consultório Isolado;0;0;0;6;6
3520905;Diagnose e Terapia;0;0;0;5;5
3520905;Hospital;0;0;0;1;1
3520905;Outros;0;0;1;3;4
3520905;Pronto Atendimento;0;0;0;0;0
3520905;Unidade Básica de Saúde;0;0;3;0;3
3520905;Unidade de Saúde Mental ;0;0;1;0;1
3520905;Unidade Móvel;0;0;1;0;1
3520905;Vigilância em Saúde;0;0;0;0;0
3521002;Clínica;0;0;1;0;1
3521002;Consultório Isolado;0;0;0;14;14
3521002;Diagnose e Terapia;0;0;0;3;3
3521002;Hospital;0;0;1;0;1
3521002;Outros;0;0;4;0;4
3521002;Pronto Atendimento;0;0;2;0;2
3521002;Unidade Básica de Saúde;1;0;5;0;6
3521002;Unidade de Saúde Mental ;0;0;1;0;1
3521002;Unidade Móvel;0;0;1;1;2
3521002;Vigilância em Saúde;0;0;2;0;2
3521101;Clínica;0;0;2;0;2
3521101;Consultório Isolado;0;0;0;0;0
3521101;Diagnose e Terapia;0;0;0;1;1
3521101;Hospital;0;0;0;0;0
3521101;Outros;0;0;2;0;2
3521101;Pronto Atendimento;0;0;0;0;0
3521101;Unidade Básica de Saúde;0;0;3;0;3
3521101;Unidade de Saúde Mental ;0;0;0;0;0
3521101;Unidade Móvel;0;0;2;0;2
3521101;Vigilância em Saúde;0;0;1;0;1
3521150;Clínica;0;0;1;0;1
3521150;Consultório Isolado;0;0;0;0;0
3521150;Diagnose e Terapia;0;0;0;0;0
3521150;Hospital;0;0;0;0;0
3521150;Outros;0;0;1;0;1
3521150;Pronto Atendimento;0;0;0;0;0
3521150;Unidade Básica de Saúde;0;0;2;0;2
3521150;Unidade de Saúde Mental ;0;0;0;0;0
3521150;Unidade Móvel;0;0;0;0;0
3521150;Vigilância em Saúde;0;0;0;0;0
3521200;Clínica;0;0;0;0;0
3521200;Consultório Isolado;0;0;0;0;0
3521200;Diagnose e Terapia;0;0;0;0;0
3521200;Hospital;0;0;0;0;0
3521200;Outros;0;0;1;0;1
3521200;Pronto Atendimento;0;0;0;0;0
3521200;Unidade Básica de Saúde;0;0;3;0;3
3521200;Unidade de Saúde Mental ;0;0;0;0;0
3521200;Unidade Móvel;0;0;1;0;1
3521200;Vigilância em Saúde;0;0;0;0;0
3521309;Clínica;0;0;1;0;1
3521309;Consultório Isolado;0;0;1;57;58
3521309;Diagnose e Terapia;0;0;0;2;2
3521309;Hospital;0;0;0;1;1
3521309;Outros;0;0;1;0;1
3521309;Pronto Atendimento;0;0;1;0;1
3521309;Unidade Básica de Saúde;0;0;6;0;6
3521309;Unidade de Saúde Mental ;0;0;1;0;1
3521309;Unidade Móvel;0;0;1;0;1
3521309;Vigilância em Saúde;0;0;1;0;1
3521408;Clínica;0;0;2;3;5
3521408;Consultório Isolado;0;0;6;13;19
3521408;Diagnose e Terapia;0;0;0;5;5
3521408;Hospital;0;0;1;0;1
3521408;Outros;0;0;2;0;2
3521408;Pronto Atendimento;0;0;1;0;1
3521408;Unidade Básica de Saúde;0;0;4;0;4
3521408;Unidade de Saúde Mental ;0;0;1;0;1
3521408;Unidade Móvel;0;0;0;0;0
3521408;Vigilância em Saúde;0;0;0;0;0
3521507;Clínica;0;0;1;0;1
3521507;Consultório Isolado;0;0;0;5;5
3521507;Diagnose e Terapia;0;0;0;1;1
3521507;Hospital;0;0;0;0;0
3521507;Outros;0;0;1;0;1
3521507;Pronto Atendimento;0;0;0;0;0
3521507;Unidade Básica de Saúde;0;0;4;0;4
3521507;Unidade de Saúde Mental ;0;0;0;0;0
3521507;Unidade Móvel;0;0;1;0;1
3521507;Vigilância em Saúde;0;0;0;0;0
3521606;Clínica;0;0;0;0;0
3521606;Consultório Isolado;0;0;0;7;7
3521606;Diagnose e Terapia;0;0;0;0;0
3521606;Hospital;0;0;0;1;1
3521606;Outros;0;0;3;0;3
3521606;Pronto Atendimento;0;0;0;0;0
3521606;Unidade Básica de Saúde;2;0;2;0;4
3521606;Unidade de Saúde Mental ;0;0;0;0;0
3521606;Unidade Móvel;0;0;0;0;0
3521606;Vigilância em Saúde;0;0;0;0;0
3521705;Clínica;0;0;2;3;5
3521705;Consultório Isolado;0;0;0;2;2
3521705;Diagnose e Terapia;0;0;0;3;3
3521705;Hospital;0;0;1;1;2
3521705;Outros;0;0;4;0;4
3521705;Pronto Atendimento;0;0;0;0;0
3521705;Unidade Básica de Saúde;0;0;12;0;12
3521705;Unidade de Saúde Mental ;0;0;1;0;1
3521705;Unidade Móvel;0;0;1;0;1
3521705;Vigilância em Saúde;0;0;1;0;1
3521804;Clínica;0;0;0;2;2
3521804;Consultório Isolado;0;0;0;23;23
3521804;Diagnose e Terapia;0;0;1;7;8
3521804;Hospital;0;0;0;1;1
3521804;Outros;0;0;4;0;4
3521804;Pronto Atendimento;0;0;0;0;0
3521804;Unidade Básica de Saúde;1;0;7;0;8
3521804;Unidade de Saúde Mental ;0;0;1;0;1
3521804;Unidade Móvel;0;0;1;0;1
3521804;Vigilância em Saúde;0;0;1;0;1
3521903;Clínica;0;0;1;1;2
3521903;Consultório Isolado;0;0;0;15;15
3521903;Diagnose e Terapia;0;0;0;4;4
3521903;Hospital;0;0;0;1;1
3521903;Outros;0;0;3;0;3
3521903;Pronto Atendimento;0;0;1;0;1
3521903;Unidade Básica de Saúde;0;0;5;0;5
3521903;Unidade de Saúde Mental ;0;0;1;0;1
3521903;Unidade Móvel;0;0;0;0;0
3521903;Vigilância em Saúde;0;0;0;0;0
3522000;Clínica;0;0;0;0;0
3522000;Consultório Isolado;0;0;0;0;0
3522000;Diagnose e Terapia;0;0;0;0;0
3522000;Hospital;0;0;0;0;0
3522000;Outros;0;0;1;1;2
3522000;Pronto Atendimento;0;0;0;0;0
3522000;Unidade Básica de Saúde;0;0;1;0;1
3522000;Unidade de Saúde Mental ;0;0;0;0;0
3522000;Unidade Móvel;0;0;0;0;0
3522000;Vigilância em Saúde;0;0;0;0;0
3522109;Clínica;0;0;7;15;22
3522109;Consultório Isolado;0;0;0;36;36
3522109;Diagnose e Terapia;0;0;1;4;5
3522109;Hospital;1;0;0;1;2
3522109;Outros;0;0;7;3;10
3522109;Pronto Atendimento;0;0;2;0;2
3522109;Unidade Básica de Saúde;0;0;10;0;10
3522109;Unidade de Saúde Mental ;0;0;3;0;3
3522109;Unidade Móvel;0;0;7;0;7
3522109;Vigilância em Saúde;0;0;1;0;1
3522158;Clínica;0;0;0;0;0
3522158;Consultório Isolado;0;0;0;0;0
3522158;Diagnose e Terapia;0;0;0;0;0
3522158;Hospital;0;0;0;0;0
3522158;Outros;0;0;2;0;2
3522158;Pronto Atendimento;0;0;0;0;0
3522158;Unidade Básica de Saúde;0;0;1;0;1
3522158;Unidade de Saúde Mental ;0;0;0;0;0
3522158;Unidade Móvel;0;0;1;0;1
3522158;Vigilância em Saúde;0;0;1;0;1
3522208;Clínica;1;0;2;17;20
3522208;Consultório Isolado;0;0;0;31;31
3522208;Diagnose e Terapia;0;0;1;2;3
3522208;Hospital;1;0;1;3;5
3522208;Outros;0;0;1;4;5
3522208;Pronto Atendimento;0;0;2;0;2
3522208;Unidade Básica de Saúde;0;0;12;0;12
3522208;Unidade de Saúde Mental ;0;0;1;0;1
3522208;Unidade Móvel;0;0;2;0;2
3522208;Vigilância em Saúde;0;0;1;0;1
3522307;Clínica;1;0;16;22;39
3522307;Consultório Isolado;1;0;1;363;365
3522307;Diagnose e Terapia;0;0;3;24;27
3522307;Hospital;0;0;1;1;2
3522307;Outros;0;0;8;5;13
3522307;Pronto Atendimento;0;0;0;0;0
3522307;Unidade Básica de Saúde;3;0;28;1;32
3522307;Unidade de Saúde Mental ;0;0;3;0;3
3522307;Unidade Móvel;0;0;10;3;13
3522307;Vigilância em Saúde;1;0;3;0;4
3522406;Clínica;1;0;5;31;37
3522406;Consultório Isolado;0;0;0;216;216
3522406;Diagnose e Terapia;0;0;0;7;7
3522406;Hospital;1;0;1;2;4
3522406;Outros;1;0;8;9;18
3522406;Pronto Atendimento;0;0;1;0;1
3522406;Unidade Básica de Saúde;0;0;26;1;27
3522406;Unidade de Saúde Mental ;0;0;3;0;3
3522406;Unidade Móvel;0;0;2;0;2
3522406;Vigilância em Saúde;1;0;2;0;3
3522505;Clínica;1;0;6;21;28
3522505;Consultório Isolado;0;0;0;50;50
3522505;Diagnose e Terapia;0;0;0;11;11
3522505;Hospital;1;0;0;3;4
3522505;Outros;0;0;7;0;7
3522505;Pronto Atendimento;0;0;4;3;7
3522505;Unidade Básica de Saúde;0;0;15;0;15
3522505;Unidade de Saúde Mental ;0;0;3;0;3
3522505;Unidade Móvel;0;0;9;0;9
3522505;Vigilância em Saúde;0;0;3;0;3
3522604;Clínica;0;0;5;15;20
3522604;Consultório Isolado;0;0;0;168;168
3522604;Diagnose e Terapia;0;0;0;11;11
3522604;Hospital;0;0;2;4;6
3522604;Outros;0;0;3;0;3
3522604;Pronto Atendimento;0;0;0;0;0
3522604;Unidade Básica de Saúde;0;0;16;0;16
3522604;Unidade de Saúde Mental ;0;0;2;0;2
3522604;Unidade Móvel;0;0;2;0;2
3522604;Vigilância em Saúde;0;0;1;0;1
3522653;Clínica;0;0;1;0;1
3522653;Consultório Isolado;0;0;0;0;0
3522653;Diagnose e Terapia;0;0;0;0;0
3522653;Hospital;0;0;0;0;0
3522653;Outros;0;0;3;0;3
3522653;Pronto Atendimento;0;0;0;0;0
3522653;Unidade Básica de Saúde;0;0;2;0;2
3522653;Unidade de Saúde Mental ;0;0;0;0;0
3522653;Unidade Móvel;0;0;1;0;1
3522653;Vigilância em Saúde;0;0;2;0;2
3522703;Clínica;0;0;2;14;16
3522703;Consultório Isolado;0;0;1;94;95
3522703;Diagnose e Terapia;0;0;0;10;10
3522703;Hospital;0;0;0;1;1
3522703;Outros;0;0;1;0;1
3522703;Pronto Atendimento;0;0;0;0;0
3522703;Unidade Básica de Saúde;0;0;9;0;9
3522703;Unidade de Saúde Mental ;0;0;1;0;1
3522703;Unidade Móvel;0;0;2;0;2
3522703;Vigilância em Saúde;0;0;0;0;0
3522802;Clínica;0;0;1;2;3
3522802;Consultório Isolado;0;0;0;4;4
3522802;Diagnose e Terapia;0;0;0;5;5
3522802;Hospital;0;0;0;1;1
3522802;Outros;0;1;4;0;5
3522802;Pronto Atendimento;0;0;0;0;0
3522802;Unidade Básica de Saúde;0;0;4;0;4
3522802;Unidade de Saúde Mental ;0;0;0;0;0
3522802;Unidade Móvel;0;0;1;0;1
3522802;Vigilância em Saúde;0;0;1;0;1
3522901;Clínica;0;0;1;1;2
3522901;Consultório Isolado;0;0;0;2;2
3522901;Diagnose e Terapia;0;0;0;3;3
3522901;Hospital;0;0;1;0;1
3522901;Outros;0;0;3;0;3
3522901;Pronto Atendimento;0;0;1;0;1
3522901;Unidade Básica de Saúde;0;0;4;0;4
3522901;Unidade de Saúde Mental ;0;0;1;0;1
3522901;Unidade Móvel;0;0;1;0;1
3522901;Vigilância em Saúde;0;0;0;0;0
3523008;Clínica;0;0;0;0;0
3523008;Consultório Isolado;0;0;1;0;1
3523008;Diagnose e Terapia;0;0;0;2;2
3523008;Hospital;0;0;0;0;0
3523008;Outros;0;0;2;0;2
3523008;Pronto Atendimento;0;0;0;0;0
3523008;Unidade Básica de Saúde;0;0;2;0;2
3523008;Unidade de Saúde Mental ;0;0;0;0;0
3523008;Unidade Móvel;0;0;0;0;0
3523008;Vigilância em Saúde;0;0;0;0;0
3523107;Clínica;0;0;6;24;30
3523107;Consultório Isolado;0;0;0;36;36
3523107;Diagnose e Terapia;0;0;1;10;11
3523107;Hospital;1;0;1;0;2
3523107;Outros;0;0;6;1;7
3523107;Pronto Atendimento;0;0;4;2;6
3523107;Unidade Básica de Saúde;0;0;17;0;17
3523107;Unidade de Saúde Mental ;0;0;0;0;0
3523107;Unidade Móvel;0;0;7;0;7
3523107;Vigilância em Saúde;0;0;2;0;2
3523206;Clínica;0;0;6;5;11
3523206;Consultório Isolado;0;0;0;61;61
3523206;Diagnose e Terapia;0;0;1;7;8
3523206;Hospital;0;0;0;1;1
3523206;Outros;0;0;5;0;5
3523206;Pronto Atendimento;0;0;0;0;0
3523206;Unidade Básica de Saúde;0;0;14;0;14
3523206;Unidade de Saúde Mental ;0;0;1;0;1
3523206;Unidade Móvel;0;0;1;0;1
3523206;Vigilância em Saúde;0;0;0;0;0
3523305;Clínica;0;0;0;0;0
3523305;Consultório Isolado;0;0;0;2;2
3523305;Diagnose e Terapia;0;0;0;1;1
3523305;Hospital;0;0;0;0;0
3523305;Outros;0;0;2;1;3
3523305;Pronto Atendimento;0;0;1;0;1
3523305;Unidade Básica de Saúde;0;0;6;0;6
3523305;Unidade de Saúde Mental ;0;0;0;0;0
3523305;Unidade Móvel;0;0;1;0;1
3523305;Vigilância em Saúde;0;0;0;0;0
3523404;Clínica;0;0;6;40;46
3523404;Consultório Isolado;0;0;1;120;121
3523404;Diagnose e Terapia;0;0;0;19;19
3523404;Hospital;0;0;0;4;4
3523404;Outros;0;0;4;1;5
3523404;Pronto Atendimento;0;0;1;1;2
3523404;Unidade Básica de Saúde;0;0;23;0;23
3523404;Unidade de Saúde Mental ;0;0;2;0;2
3523404;Unidade Móvel;0;0;3;0;3
3523404;Vigilância em Saúde;0;0;2;0;2
3523503;Clínica;0;0;0;2;2
3523503;Consultório Isolado;0;0;0;18;18
3523503;Diagnose e Terapia;0;0;0;2;2
3523503;Hospital;0;0;0;1;1
3523503;Outros;0;0;2;0;2
3523503;Pronto Atendimento;0;0;0;0;0
3523503;Unidade Básica de Saúde;0;0;3;0;3
3523503;Unidade de Saúde Mental ;0;0;0;0;0
3523503;Unidade Móvel;0;0;0;0;0
3523503;Vigilância em Saúde;0;0;0;0;0
3523602;Clínica;0;0;1;0;1
3523602;Consultório Isolado;0;0;1;21;22
3523602;Diagnose e Terapia;0;0;0;2;2
3523602;Hospital;0;0;1;0;1
3523602;Outros;0;0;1;0;1
3523602;Pronto Atendimento;0;0;0;0;0
3523602;Unidade Básica de Saúde;2;0;4;0;6
3523602;Unidade de Saúde Mental ;0;0;0;0;0
3523602;Unidade Móvel;0;0;3;0;3
3523602;Vigilância em Saúde;0;0;1;0;1
3523701;Clínica;0;0;1;0;1
3523701;Consultório Isolado;0;0;1;0;1
3523701;Diagnose e Terapia;0;0;0;0;0
3523701;Hospital;0;0;0;0;0
3523701;Outros;0;0;1;0;1
3523701;Pronto Atendimento;0;0;0;0;0
3523701;Unidade Básica de Saúde;0;0;3;0;3
3523701;Unidade de Saúde Mental ;0;0;0;0;0
3523701;Unidade Móvel;0;0;0;0;0
3523701;Vigilância em Saúde;0;0;1;0;1
3523800;Clínica;0;0;0;1;1
3523800;Consultório Isolado;0;0;0;3;3
3523800;Diagnose e Terapia;0;0;0;0;0
3523800;Hospital;0;0;0;0;0
3523800;Outros;0;0;1;0;1
3523800;Pronto Atendimento;0;0;0;0;0
3523800;Unidade Básica de Saúde;0;0;1;0;1
3523800;Unidade de Saúde Mental ;0;0;0;0;0
3523800;Unidade Móvel;0;0;0;0;0
3523800;Vigilância em Saúde;0;0;0;0;0
3523909;Clínica;1;0;18;85;104
3523909;Consultório Isolado;0;0;1;210;211
3523909;Diagnose e Terapia;0;0;2;27;29
3523909;Hospital;2;0;3;0;5
3523909;Outros;1;0;9;4;14
3523909;Pronto Atendimento;0;0;5;1;6
3523909;Unidade Básica de Saúde;0;0;18;0;18
3523909;Unidade de Saúde Mental ;0;0;2;0;2
3523909;Unidade Móvel;0;0;3;0;3
3523909;Vigilância em Saúde;0;0;5;0;5
3524006;Clínica;0;0;7;6;13
3524006;Consultório Isolado;0;0;3;43;46
3524006;Diagnose e Terapia;0;0;0;5;5
3524006;Hospital;0;0;2;1;3
3524006;Outros;0;0;3;1;4
3524006;Pronto Atendimento;0;0;0;0;0
3524006;Unidade Básica de Saúde;0;0;13;0;13
3524006;Unidade de Saúde Mental ;0;0;1;0;1
3524006;Unidade Móvel;0;0;2;1;3
3524006;Vigilância em Saúde;0;0;0;0;0
3524105;Clínica;1;0;2;7;10
3524105;Consultório Isolado;0;0;0;193;193
3524105;Diagnose e Terapia;0;0;0;11;11
3524105;Hospital;0;0;0;2;2
3524105;Outros;0;0;11;3;14
3524105;Pronto Atendimento;0;0;0;0;0
3524105;Unidade Básica de Saúde;0;0;14;0;14
3524105;Unidade de Saúde Mental ;0;0;1;0;1
3524105;Unidade Móvel;0;0;1;1;2
3524105;Vigilância em Saúde;0;0;1;0;1
3524204;Clínica;0;0;1;0;1
3524204;Consultório Isolado;0;0;0;3;3
3524204;Diagnose e Terapia;0;0;0;2;2
3524204;Hospital;0;0;1;0;1
3524204;Outros;0;0;2;0;2
3524204;Pronto Atendimento;0;0;0;0;0
3524204;Unidade Básica de Saúde;0;0;3;0;3
3524204;Unidade de Saúde Mental ;0;0;0;0;0
3524204;Unidade Móvel;0;0;1;0;1
3524204;Vigilância em Saúde;0;0;0;0;0
3524303;Clínica;0;0;5;28;33
3524303;Consultório Isolado;0;0;0;146;146
3524303;Diagnose e Terapia;0;0;1;10;11
3524303;Hospital;0;0;0;2;2
3524303;Outros;0;0;4;0;4
3524303;Pronto Atendimento;0;0;1;2;3
3524303;Unidade Básica de Saúde;0;0;12;0;12
3524303;Unidade de Saúde Mental ;0;0;1;0;1
3524303;Unidade Móvel;0;0;3;0;3
3524303;Vigilância em Saúde;0;0;2;0;2
3524402;Clínica;0;0;4;49;53
3524402;Consultório Isolado;1;0;0;456;457
3524402;Diagnose e Terapia;0;0;3;42;45
3524402;Hospital;0;0;1;6;7
3524402;Outros;0;0;5;6;11
3524402;Pronto Atendimento;0;0;3;1;4
3524402;Unidade Básica de Saúde;0;0;18;0;18
3524402;Unidade de Saúde Mental ;0;0;3;0;3
3524402;Unidade Móvel;0;0;4;1;5
3524402;Vigilância em Saúde;0;0;2;0;2
3524501;Clínica;0;0;0;5;5
3524501;Consultório Isolado;0;0;0;0;0
3524501;Diagnose e Terapia;0;0;0;1;1
3524501;Hospital;0;0;0;1;1
3524501;Outros;0;0;1;0;1
3524501;Pronto Atendimento;0;0;0;0;0
3524501;Unidade Básica de Saúde;0;0;3;0;3
3524501;Unidade de Saúde Mental ;0;0;0;0;0
3524501;Unidade Móvel;0;0;0;0;0
3524501;Vigilância em Saúde;0;0;0;0;0
3524600;Clínica;0;0;1;0;1
3524600;Consultório Isolado;0;0;0;8;8
3524600;Diagnose e Terapia;0;0;1;2;3
3524600;Hospital;0;0;0;0;0
3524600;Outros;0;0;2;0;2
3524600;Pronto Atendimento;0;0;1;0;1
3524600;Unidade Básica de Saúde;0;0;7;0;7
3524600;Unidade de Saúde Mental ;0;0;0;0;0
3524600;Unidade Móvel;0;0;0;0;0
3524600;Vigilância em Saúde;0;0;1;0;1
3524709;Clínica;0;0;6;21;27
3524709;Consultório Isolado;0;0;0;57;57
3524709;Diagnose e Terapia;0;0;1;16;17
3524709;Hospital;0;0;1;1;2
3524709;Outros;0;0;7;1;8
3524709;Pronto Atendimento;0;0;1;0;1
3524709;Unidade Básica de Saúde;0;0;12;0;12
3524709;Unidade de Saúde Mental ;0;0;1;0;1
3524709;Unidade Móvel;0;0;3;1;4
3524709;Vigilância em Saúde;0;0;1;0;1
3524808;Clínica;1;0;7;16;24
3524808;Consultório Isolado;0;0;0;234;234
3524808;Diagnose e Terapia;0;0;1;19;20
3524808;Hospital;0;0;0;2;2
3524808;Outros;1;0;4;1;6
3524808;Pronto Atendimento;0;0;1;0;1
3524808;Unidade Básica de Saúde;0;0;11;0;11
3524808;Unidade de Saúde Mental ;0;0;1;0;1
3524808;Unidade Móvel;0;0;4;0;4
3524808;Vigilância em Saúde;1;0;1;0;2
3524907;Clínica;0;0;1;1;2
3524907;Consultório Isolado;0;0;0;2;2
3524907;Diagnose e Terapia;0;0;0;0;0
3524907;Hospital;0;0;0;0;0
3524907;Outros;0;0;3;0;3
3524907;Pronto Atendimento;0;0;0;0;0
3524907;Unidade Básica de Saúde;0;0;1;1;2
3524907;Unidade de Saúde Mental ;0;0;0;0;0
3524907;Unidade Móvel;0;0;1;0;1
3524907;Vigilância em Saúde;0;0;0;0;0
3525003;Clínica;0;0;5;16;21
3525003;Consultório Isolado;0;0;0;17;17
3525003;Diagnose e Terapia;0;0;0;2;2
3525003;Hospital;0;0;1;1;2
3525003;Outros;0;0;4;1;5
3525003;Pronto Atendimento;0;0;3;0;3
3525003;Unidade Básica de Saúde;0;0;10;0;10
3525003;Unidade de Saúde Mental ;0;0;1;0;1
3525003;Unidade Móvel;0;0;5;0;5
3525003;Vigilância em Saúde;0;0;3;0;3
3525102;Clínica;0;0;4;9;13
3525102;Consultório Isolado;0;0;0;41;41
3525102;Diagnose e Terapia;0;0;0;5;5
3525102;Hospital;0;0;0;1;1
3525102;Outros;0;0;3;1;4
3525102;Pronto Atendimento;0;0;1;0;1
3525102;Unidade Básica de Saúde;1;0;11;0;12
3525102;Unidade de Saúde Mental ;0;0;0;0;0
3525102;Unidade Móvel;0;0;1;0;1
3525102;Vigilância em Saúde;0;0;1;0;1
3525201;Clínica;0;0;2;2;4
3525201;Consultório Isolado;0;0;0;10;10
3525201;Diagnose e Terapia;0;0;0;4;4
3525201;Hospital;0;0;0;1;1
3525201;Outros;0;0;4;0;4
3525201;Pronto Atendimento;0;0;0;0;0
3525201;Unidade Básica de Saúde;0;0;6;0;6
3525201;Unidade de Saúde Mental ;0;0;1;0;1
3525201;Unidade Móvel;0;0;0;0;0
3525201;Vigilância em Saúde;0;0;1;0;1
3525300;Clínica;0;0;16;114;130
3525300;Consultório Isolado;0;0;0;477;477
3525300;Diagnose e Terapia;0;0;2;19;21
3525300;Hospital;0;0;0;4;4
3525300;Outros;0;0;6;0;6
3525300;Pronto Atendimento;0;0;2;0;2
3525300;Unidade Básica de Saúde;1;0;18;0;19
3525300;Unidade de Saúde Mental ;0;0;1;0;1
3525300;Unidade Móvel;0;0;8;0;8
3525300;Vigilância em Saúde;0;0;2;0;2
3525409;Clínica;0;0;0;0;0
3525409;Consultório Isolado;0;0;0;0;0
3525409;Diagnose e Terapia;0;0;0;0;0
3525409;Hospital;0;0;0;0;0
3525409;Outros;0;0;1;0;1
3525409;Pronto Atendimento;0;0;0;0;0
3525409;Unidade Básica de Saúde;0;0;2;0;2
3525409;Unidade de Saúde Mental ;0;0;0;0;0
3525409;Unidade Móvel;0;0;0;0;0
3525409;Vigilância em Saúde;0;0;0;0;0
3525508;Clínica;0;0;1;1;2
3525508;Consultório Isolado;0;0;0;7;7
3525508;Diagnose e Terapia;0;0;0;1;1
3525508;Hospital;0;0;0;1;1
3525508;Outros;0;0;1;0;1
3525508;Pronto Atendimento;0;0;0;0;0
3525508;Unidade Básica de Saúde;0;0;3;0;3
3525508;Unidade de Saúde Mental ;0;0;0;0;0
3525508;Unidade Móvel;0;0;1;0;1
3525508;Vigilância em Saúde;0;0;1;0;1
3525607;Clínica;0;0;0;0;0
3525607;Consultório Isolado;0;0;1;2;3
3525607;Diagnose e Terapia;0;0;0;0;0
3525607;Hospital;0;0;0;0;0
3525607;Outros;0;0;1;0;1
3525607;Pronto Atendimento;0;0;0;0;0
3525607;Unidade Básica de Saúde;0;0;3;0;3
3525607;Unidade de Saúde Mental ;0;0;0;0;0
3525607;Unidade Móvel;0;0;0;0;0
3525607;Vigilância em Saúde;0;0;0;0;0
3525706;Clínica;0;0;1;7;8
3525706;Consultório Isolado;0;0;1;46;47
3525706;Diagnose e Terapia;0;0;1;4;5
3525706;Hospital;0;0;0;1;1
3525706;Outros;0;0;2;0;2
3525706;Pronto Atendimento;0;0;0;0;0
3525706;Unidade Básica de Saúde;0;0;10;0;10
3525706;Unidade de Saúde Mental ;0;0;0;0;0
3525706;Unidade Móvel;0;0;1;0;1
3525706;Vigilância em Saúde;0;0;0;0;0
3525805;Clínica;0;0;0;1;1
3525805;Consultório Isolado;0;0;0;1;1
3525805;Diagnose e Terapia;0;0;0;0;0
3525805;Hospital;0;0;0;0;0
3525805;Outros;0;0;1;0;1
3525805;Pronto Atendimento;0;0;0;0;0
3525805;Unidade Básica de Saúde;0;0;2;0;2
3525805;Unidade de Saúde Mental ;0;0;0;0;0
3525805;Unidade Móvel;0;0;0;0;0
3525805;Vigilância em Saúde;0;0;0;0;0
3525854;Clínica;0;0;0;0;0
3525854;Consultório Isolado;0;0;0;3;3
3525854;Diagnose e Terapia;0;0;0;0;0
3525854;Hospital;0;0;0;0;0
3525854;Outros;0;0;3;0;3
3525854;Pronto Atendimento;0;0;0;0;0
3525854;Unidade Básica de Saúde;0;0;1;0;1
3525854;Unidade de Saúde Mental ;0;0;0;0;0
3525854;Unidade Móvel;0;0;0;0;0
3525854;Vigilância em Saúde;0;0;1;0;1
3525904;Clínica;1;0;17;245;263
3525904;Consultório Isolado;0;0;0;1456;1456
3525904;Diagnose e Terapia;1;0;0;73;74
3525904;Hospital;1;0;1;10;12
3525904;Outros;0;0;15;22;37
3525904;Pronto Atendimento;0;0;5;2;7
3525904;Unidade Básica de Saúde;1;0;39;0;40
3525904;Unidade de Saúde Mental ;0;0;4;0;4
3525904;Unidade Móvel;0;0;8;3;11
3525904;Vigilância em Saúde;0;0;4;0;4
3526001;Clínica;0;0;1;1;2
3526001;Consultório Isolado;0;0;0;21;21
3526001;Diagnose e Terapia;0;0;1;2;3
3526001;Hospital;0;0;0;1;1
3526001;Outros;0;0;1;0;1
3526001;Pronto Atendimento;0;0;1;0;1
3526001;Unidade Básica de Saúde;1;0;9;0;10
3526001;Unidade de Saúde Mental ;0;0;1;0;1
3526001;Unidade Móvel;0;0;0;0;0
3526001;Vigilância em Saúde;0;0;0;0;0
3526100;Clínica;0;0;0;0;0
3526100;Consultório Isolado;0;0;0;2;2
3526100;Diagnose e Terapia;0;0;1;2;3
3526100;Hospital;0;0;0;0;0
3526100;Outros;0;0;3;0;3
3526100;Pronto Atendimento;0;0;1;0;1
3526100;Unidade Básica de Saúde;0;0;8;0;8
3526100;Unidade de Saúde Mental ;0;0;0;0;0
3526100;Unidade Móvel;0;0;0;0;0
3526100;Vigilância em Saúde;0;0;2;0;2
3526209;Clínica;0;0;0;1;1
3526209;Consultório Isolado;0;0;0;5;5
3526209;Diagnose e Terapia;0;0;0;0;0
3526209;Hospital;0;0;1;0;1
3526209;Outros;0;0;1;2;3
3526209;Pronto Atendimento;0;0;0;0;0
3526209;Unidade Básica de Saúde;0;0;9;0;9
3526209;Unidade de Saúde Mental ;0;0;1;0;1
3526209;Unidade Móvel;0;0;2;0;2
3526209;Vigilância em Saúde;0;0;1;0;1
3526308;Clínica;0;0;0;1;1
3526308;Consultório Isolado;0;0;0;0;0
3526308;Diagnose e Terapia;0;0;0;0;0
3526308;Hospital;0;0;0;0;0
3526308;Outros;0;0;2;0;2
3526308;Pronto Atendimento;0;0;0;0;0
3526308;Unidade Básica de Saúde;0;0;4;0;4
3526308;Unidade de Saúde Mental ;0;0;0;0;0
3526308;Unidade Móvel;0;0;1;0;1
3526308;Vigilância em Saúde;0;0;0;0;0
3526407;Clínica;0;0;4;4;8
3526407;Consultório Isolado;0;0;0;69;69
3526407;Diagnose e Terapia;0;0;2;6;8
3526407;Hospital;0;0;0;1;1
3526407;Outros;0;0;2;0;2
3526407;Pronto Atendimento;0;0;0;0;0
3526407;Unidade Básica de Saúde;0;0;7;0;7
3526407;Unidade de Saúde Mental ;0;0;1;0;1
3526407;Unidade Móvel;0;0;0;0;0
3526407;Vigilância em Saúde;0;0;1;0;1
3526506;Clínica;0;0;0;0;0
3526506;Consultório Isolado;0;0;4;0;4
3526506;Diagnose e Terapia;0;0;0;0;0
3526506;Hospital;0;0;0;0;0
3526506;Outros;0;0;2;0;2
3526506;Pronto Atendimento;0;0;0;0;0
3526506;Unidade Básica de Saúde;4;0;2;0;6
3526506;Unidade de Saúde Mental ;0;0;0;0;0
3526506;Unidade Móvel;0;0;0;0;0
3526506;Vigilância em Saúde;0;0;1;0;1
3526605;Clínica;0;0;0;0;0
3526605;Consultório Isolado;0;0;0;0;0
3526605;Diagnose e Terapia;0;0;1;0;1
3526605;Hospital;0;0;0;0;0
3526605;Outros;0;0;1;1;2
3526605;Pronto Atendimento;0;0;0;0;0
3526605;Unidade Básica de Saúde;0;0;5;0;5
3526605;Unidade de Saúde Mental ;0;0;0;0;0
3526605;Unidade Móvel;0;0;0;0;0
3526605;Vigilância em Saúde;0;0;0;0;0
3526704;Clínica;0;0;9;11;20
3526704;Consultório Isolado;0;0;2;174;176
3526704;Diagnose e Terapia;0;0;0;17;17
3526704;Hospital;0;0;0;2;2
3526704;Outros;0;0;2;0;2
3526704;Pronto Atendimento;0;0;1;1;2
3526704;Unidade Básica de Saúde;0;0;19;0;19
3526704;Unidade de Saúde Mental ;0;0;3;0;3
3526704;Unidade Móvel;0;0;4;1;5
3526704;Vigilância em Saúde;0;0;3;0;3
3526803;Clínica;0;0;3;12;15
3526803;Consultório Isolado;0;0;2;228;230
3526803;Diagnose e Terapia;0;0;0;30;30
3526803;Hospital;0;0;0;2;2
3526803;Outros;0;0;2;0;2
3526803;Pronto Atendimento;0;0;1;0;1
3526803;Unidade Básica de Saúde;0;0;10;0;10
3526803;Unidade de Saúde Mental ;0;0;1;0;1
3526803;Unidade Móvel;0;0;3;0;3
3526803;Vigilância em Saúde;0;0;0;0;0
3526902;Clínica;2;0;6;60;68
3526902;Consultório Isolado;0;0;0;772;772
3526902;Diagnose e Terapia;0;0;3;110;113
3526902;Hospital;0;0;0;5;5
3526902;Outros;0;0;4;40;44
3526902;Pronto Atendimento;0;0;1;0;1
3526902;Unidade Básica de Saúde;3;0;35;0;38
3526902;Unidade de Saúde Mental ;0;0;3;0;3
3526902;Unidade Móvel;0;0;5;0;5
3526902;Vigilância em Saúde;0;0;3;0;3
3527009;Clínica;0;0;2;0;2
3527009;Consultório Isolado;0;0;0;4;4
3527009;Diagnose e Terapia;0;0;0;4;4
3527009;Hospital;0;0;0;0;0
3527009;Outros;0;0;2;0;2
3527009;Pronto Atendimento;0;0;1;0;1
3527009;Unidade Básica de Saúde;0;0;3;0;3
3527009;Unidade de Saúde Mental ;0;0;0;0;0
3527009;Unidade Móvel;0;0;0;2;2
3527009;Vigilância em Saúde;0;0;1;0;1
3527108;Clínica;1;0;4;19;24
3527108;Consultório Isolado;0;0;0;497;497
3527108;Diagnose e Terapia;1;0;1;34;36
3527108;Hospital;1;0;0;4;5
3527108;Outros;0;0;6;3;9
3527108;Pronto Atendimento;0;0;0;0;0
3527108;Unidade Básica de Saúde;1;0;15;0;16
3527108;Unidade de Saúde Mental ;0;0;3;0;3
3527108;Unidade Móvel;0;0;0;2;2
3527108;Vigilância em Saúde;0;0;2;0;2
3527207;Clínica;1;0;5;21;27
3527207;Consultório Isolado;1;0;0;263;264
3527207;Diagnose e Terapia;0;0;2;16;18
3527207;Hospital;0;0;0;2;2
3527207;Outros;0;0;3;24;27
3527207;Pronto Atendimento;0;0;1;0;1
3527207;Unidade Básica de Saúde;0;0;20;0;20
3527207;Unidade de Saúde Mental ;0;0;1;0;1
3527207;Unidade Móvel;0;0;1;1;2
3527207;Vigilância em Saúde;0;0;0;0;0
3527256;Clínica;0;0;0;0;0
3527256;Consultório Isolado;0;0;1;0;1
3527256;Diagnose e Terapia;0;0;0;0;0
3527256;Hospital;0;0;0;0;0
3527256;Outros;0;0;3;0;3
3527256;Pronto Atendimento;0;0;0;0;0
3527256;Unidade Básica de Saúde;0;0;2;0;2
3527256;Unidade de Saúde Mental ;0;0;0;0;0
3527256;Unidade Móvel;0;0;0;0;0
3527256;Vigilância em Saúde;0;0;1;0;1
3527306;Clínica;0;0;3;16;19
3527306;Consultório Isolado;0;0;0;25;25
3527306;Diagnose e Terapia;0;0;1;5;6
3527306;Hospital;0;0;0;2;2
3527306;Outros;0;0;1;0;1
3527306;Pronto Atendimento;0;0;0;0;0
3527306;Unidade Básica de Saúde;0;0;6;0;6
3527306;Unidade de Saúde Mental ;0;0;1;0;1
3527306;Unidade Móvel;0;0;0;0;0
3527306;Vigilância em Saúde;0;0;1;0;1
3527405;Clínica;0;0;0;4;4
3527405;Consultório Isolado;0;0;0;31;31
3527405;Diagnose e Terapia;0;0;0;0;0
3527405;Hospital;0;0;0;1;1
3527405;Outros;0;0;4;0;4
3527405;Pronto Atendimento;0;0;0;0;0
3527405;Unidade Básica de Saúde;1;0;7;0;8
3527405;Unidade de Saúde Mental ;0;0;1;0;1
3527405;Unidade Móvel;0;0;0;0;0
3527405;Vigilância em Saúde;0;0;0;0;0
3527504;Clínica;0;0;0;0;0
3527504;Consultório Isolado;0;0;0;0;0
3527504;Diagnose e Terapia;0;0;0;0;0
3527504;Hospital;0;0;0;0;0
3527504;Outros;0;0;2;0;2
3527504;Pronto Atendimento;0;0;0;0;0
3527504;Unidade Básica de Saúde;0;0;1;0;1
3527504;Unidade de Saúde Mental ;0;0;0;0;0
3527504;Unidade Móvel;0;0;0;0;0
3527504;Vigilância em Saúde;0;0;0;0;0
3527603;Clínica;0;0;1;1;2
3527603;Consultório Isolado;0;0;0;14;14
3527603;Diagnose e Terapia;0;0;0;2;2
3527603;Hospital;0;0;0;0;0
3527603;Outros;0;0;2;0;2
3527603;Pronto Atendimento;0;0;0;0;0
3527603;Unidade Básica de Saúde;0;0;6;0;6
3527603;Unidade de Saúde Mental ;0;0;0;0;0
3527603;Unidade Móvel;0;0;1;0;1
3527603;Vigilância em Saúde;0;0;1;0;1
3527702;Clínica;0;0;0;0;0
3527702;Consultório Isolado;0;0;0;4;4
3527702;Diagnose e Terapia;0;0;0;0;0
3527702;Hospital;0;0;0;1;1
3527702;Outros;0;0;2;0;2
3527702;Pronto Atendimento;0;0;0;0;0
3527702;Unidade Básica de Saúde;0;0;1;0;1
3527702;Unidade de Saúde Mental ;0;0;0;0;0
3527702;Unidade Móvel;0;0;0;0;0
3527702;Vigilância em Saúde;0;0;0;0;0
3527801;Clínica;0;0;0;0;0
3527801;Consultório Isolado;0;0;0;0;0
3527801;Diagnose e Terapia;0;0;0;1;1
3527801;Hospital;0;0;0;0;0
3527801;Outros;0;0;2;0;2
3527801;Pronto Atendimento;0;0;0;0;0
3527801;Unidade Básica de Saúde;0;0;2;0;2
3527801;Unidade de Saúde Mental ;0;0;0;0;0
3527801;Unidade Móvel;0;0;0;0;0
3527801;Vigilância em Saúde;0;0;0;0;0
3527900;Clínica;0;0;0;0;0
3527900;Consultório Isolado;0;0;0;0;0
3527900;Diagnose e Terapia;0;0;0;0;0
3527900;Hospital;0;0;0;0;0
3527900;Outros;0;0;2;0;2
3527900;Pronto Atendimento;0;0;0;0;0
3527900;Unidade Básica de Saúde;0;0;1;0;1
3527900;Unidade de Saúde Mental ;0;0;0;0;0
3527900;Unidade Móvel;0;0;0;0;0
3527900;Vigilância em Saúde;0;0;0;0;0
3528007;Clínica;0;0;3;12;15
3528007;Consultório Isolado;0;0;0;24;24
3528007;Diagnose e Terapia;0;0;1;2;3
3528007;Hospital;0;0;0;1;1
3528007;Outros;0;0;1;0;1
3528007;Pronto Atendimento;0;0;0;0;0
3528007;Unidade Básica de Saúde;0;0;4;0;4
3528007;Unidade de Saúde Mental ;0;0;1;0;1
3528007;Unidade Móvel;0;0;0;0;0
3528007;Vigilância em Saúde;0;0;1;0;1
3528106;Clínica;0;0;2;1;3
3528106;Consultório Isolado;0;0;0;6;6
3528106;Diagnose e Terapia;0;0;1;1;2
3528106;Hospital;0;0;0;1;1
3528106;Outros;0;0;1;0;1
3528106;Pronto Atendimento;0;0;0;0;0
3528106;Unidade Básica de Saúde;0;0;2;0;2
3528106;Unidade de Saúde Mental ;0;0;0;0;0
3528106;Unidade Móvel;0;0;0;0;0
3528106;Vigilância em Saúde;0;0;0;0;0
3528205;Clínica;0;0;0;0;0
3528205;Consultório Isolado;0;0;0;2;2
3528205;Diagnose e Terapia;0;0;0;0;0
3528205;Hospital;0;0;0;0;0
3528205;Outros;0;0;1;0;1
3528205;Pronto Atendimento;0;0;0;0;0
3528205;Unidade Básica de Saúde;0;0;1;0;1
3528205;Unidade de Saúde Mental ;0;0;0;0;0
3528205;Unidade Móvel;0;0;0;0;0
3528205;Vigilância em Saúde;0;0;0;0;0
3528304;Clínica;0;0;1;0;1
3528304;Consultório Isolado;0;0;0;2;2
3528304;Diagnose e Terapia;0;0;0;0;0
3528304;Hospital;0;0;0;0;0
3528304;Outros;0;0;1;0;1
3528304;Pronto Atendimento;0;0;0;0;0
3528304;Unidade Básica de Saúde;0;0;1;0;1
3528304;Unidade de Saúde Mental ;0;0;0;0;0
3528304;Unidade Móvel;0;0;0;0;0
3528304;Vigilância em Saúde;0;0;0;0;0
3528403;Clínica;0;0;5;15;20
3528403;Consultório Isolado;0;0;2;35;37
3528403;Diagnose e Terapia;0;0;0;1;1
3528403;Hospital;0;0;0;0;0
3528403;Outros;0;0;3;0;3
3528403;Pronto Atendimento;0;0;1;0;1
3528403;Unidade Básica de Saúde;1;0;17;0;18
3528403;Unidade de Saúde Mental ;0;0;1;0;1
3528403;Unidade Móvel;0;0;1;0;1
3528403;Vigilância em Saúde;0;0;2;0;2
3528502;Clínica;0;0;5;10;15
3528502;Consultório Isolado;0;0;0;23;23
3528502;Diagnose e Terapia;0;0;2;5;7
3528502;Hospital;0;0;1;2;3
3528502;Outros;0;0;5;10;15
3528502;Pronto Atendimento;0;0;1;0;1
3528502;Unidade Básica de Saúde;0;0;15;0;15
3528502;Unidade de Saúde Mental ;0;0;2;0;2
3528502;Unidade Móvel;0;0;0;0;0
3528502;Vigilância em Saúde;0;0;4;0;4
3528601;Clínica;0;0;1;4;5
3528601;Consultório Isolado;0;0;0;8;8
3528601;Diagnose e Terapia;0;0;0;1;1
3528601;Hospital;0;0;0;1;1
3528601;Outros;0;0;3;0;3
3528601;Pronto Atendimento;0;0;0;0;0
3528601;Unidade Básica de Saúde;0;0;5;0;5
3528601;Unidade de Saúde Mental ;0;0;0;0;0
3528601;Unidade Móvel;0;0;0;0;0
3528601;Vigilância em Saúde;0;0;0;0;0
3528700;Clínica;0;0;0;0;0
3528700;Consultório Isolado;0;0;0;0;0
3528700;Diagnose e Terapia;0;0;0;0;0
3528700;Hospital;0;0;0;0;0
3528700;Outros;0;0;1;0;1
3528700;Pronto Atendimento;0;0;0;0;0
3528700;Unidade Básica de Saúde;1;0;3;0;4
3528700;Unidade de Saúde Mental ;0;0;0;0;0
3528700;Unidade Móvel;0;0;0;0;0
3528700;Vigilância em Saúde;0;0;0;0;0
3528809;Clínica;0;0;0;1;1
3528809;Consultório Isolado;0;0;0;5;5
3528809;Diagnose e Terapia;0;0;1;4;5
3528809;Hospital;0;0;0;1;1
3528809;Outros;0;0;2;0;2
3528809;Pronto Atendimento;0;0;0;0;0
3528809;Unidade Básica de Saúde;0;0;4;0;4
3528809;Unidade de Saúde Mental ;0;0;1;0;1
3528809;Unidade Móvel;0;0;0;0;0
3528809;Vigilância em Saúde;0;0;0;0;0
3528858;Clínica;0;0;1;0;1
3528858;Consultório Isolado;0;0;0;0;0
3528858;Diagnose e Terapia;0;0;0;1;1
3528858;Hospital;0;0;0;0;0
3528858;Outros;0;0;1;0;1
3528858;Pronto Atendimento;0;0;0;0;0
3528858;Unidade Básica de Saúde;0;0;2;0;2
3528858;Unidade de Saúde Mental ;0;0;0;0;0
3528858;Unidade Móvel;0;0;0;0;0
3528858;Vigilância em Saúde;0;0;0;0;0
3528908;Clínica;0;0;0;0;0
3528908;Consultório Isolado;0;0;0;1;1
3528908;Diagnose e Terapia;0;0;0;0;0
3528908;Hospital;0;0;0;0;0
3528908;Outros;0;0;1;0;1
3528908;Pronto Atendimento;0;0;0;0;0
3528908;Unidade Básica de Saúde;0;0;2;0;2
3528908;Unidade de Saúde Mental ;0;0;0;0;0
3528908;Unidade Móvel;0;0;0;0;0
3528908;Vigilância em Saúde;0;0;0;0;0
3529005;Clínica;4;0;10;31;45
3529005;Consultório Isolado;3;0;1;883;887
3529005;Diagnose e Terapia;2;0;0;35;37
3529005;Hospital;1;0;0;9;10
3529005;Outros;5;0;8;2;15
3529005;Pronto Atendimento;0;0;2;2;4
3529005;Unidade Básica de Saúde;1;0;51;0;52
3529005;Unidade de Saúde Mental ;1;0;2;0;3
3529005;Unidade Móvel;0;0;8;1;9
3529005;Vigilância em Saúde;0;0;3;0;3
3529104;Clínica;0;0;0;0;0
3529104;Consultório Isolado;0;0;0;0;0
3529104;Diagnose e Terapia;0;0;0;0;0
3529104;Hospital;0;0;0;0;0
3529104;Outros;0;0;1;0;1
3529104;Pronto Atendimento;0;0;0;0;0
3529104;Unidade Básica de Saúde;0;0;2;0;2
3529104;Unidade de Saúde Mental ;0;0;0;0;0
3529104;Unidade Móvel;0;0;0;0;0
3529104;Vigilância em Saúde;0;0;0;0;0
3529203;Clínica;0;0;0;4;4
3529203;Consultório Isolado;0;0;0;22;22
3529203;Diagnose e Terapia;0;0;1;2;3
3529203;Hospital;0;0;0;1;1
3529203;Outros;0;0;3;0;3
3529203;Pronto Atendimento;0;0;0;0;0
3529203;Unidade Básica de Saúde;1;0;10;0;11
3529203;Unidade de Saúde Mental ;0;0;2;0;2
3529203;Unidade Móvel;0;0;0;0;0
3529203;Vigilância em Saúde;0;0;1;0;1
3529302;Clínica;0;0;4;32;36
3529302;Consultório Isolado;0;0;1;167;168
3529302;Diagnose e Terapia;0;0;0;14;14
3529302;Hospital;0;0;0;1;1
3529302;Outros;0;0;2;0;2
3529302;Pronto Atendimento;0;0;0;1;1
3529302;Unidade Básica de Saúde;0;0;17;0;17
3529302;Unidade de Saúde Mental ;0;0;2;0;2
3529302;Unidade Móvel;1;0;3;0;4
3529302;Vigilância em Saúde;0;0;0;0;0
3529401;Clínica;1;0;8;25;34
3529401;Consultório Isolado;0;0;3;207;210
3529401;Diagnose e Terapia;0;0;1;36;37
3529401;Hospital;0;0;1;6;7
3529401;Outros;0;0;10;2;12
3529401;Pronto Atendimento;0;0;4;2;6
3529401;Unidade Básica de Saúde;1;0;24;0;25
3529401;Unidade de Saúde Mental ;0;0;3;0;3
3529401;Unidade Móvel;0;0;24;2;26
3529401;Vigilância em Saúde;0;0;2;0;2
3529500;Clínica;0;0;0;0;0
3529500;Consultório Isolado;0;0;0;2;2
3529500;Diagnose e Terapia;0;0;0;1;1
3529500;Hospital;0;0;0;0;0
3529500;Outros;0;0;2;0;2
3529500;Pronto Atendimento;0;0;0;0;0
3529500;Unidade Básica de Saúde;0;0;2;0;2
3529500;Unidade de Saúde Mental ;0;0;0;0;0
3529500;Unidade Móvel;0;0;1;0;1
3529500;Vigilância em Saúde;0;0;0;0;0
3529609;Clínica;0;0;1;0;1
3529609;Consultório Isolado;0;0;1;2;3
3529609;Diagnose e Terapia;0;0;0;0;0
3529609;Hospital;0;0;0;0;0
3529609;Outros;0;0;2;1;3
3529609;Pronto Atendimento;0;0;0;0;0
3529609;Unidade Básica de Saúde;0;0;2;0;2
3529609;Unidade de Saúde Mental ;0;0;0;0;0
3529609;Unidade Móvel;0;0;0;0;0
3529609;Vigilância em Saúde;0;0;0;0;0
3529658;Clínica;0;0;0;0;0
3529658;Consultório Isolado;0;0;0;0;0
3529658;Diagnose e Terapia;0;0;0;0;0
3529658;Hospital;0;0;0;0;0
3529658;Outros;0;0;1;0;1
3529658;Pronto Atendimento;0;0;0;0;0
3529658;Unidade Básica de Saúde;0;0;1;0;1
3529658;Unidade de Saúde Mental ;0;0;0;0;0
3529658;Unidade Móvel;0;0;0;0;0
3529658;Vigilância em Saúde;0;0;0;0;0
3529708;Clínica;0;0;2;4;6
3529708;Consultório Isolado;0;0;0;30;30
3529708;Diagnose e Terapia;0;0;0;6;6
3529708;Hospital;0;0;0;1;1
3529708;Outros;0;0;1;1;2
3529708;Pronto Atendimento;0;0;1;0;1
3529708;Unidade Básica de Saúde;0;0;9;0;9
3529708;Unidade de Saúde Mental ;0;0;0;0;0
3529708;Unidade Móvel;0;0;1;0;1
3529708;Vigilância em Saúde;0;0;1;0;1
3529807;Clínica;0;0;2;2;4
3529807;Consultório Isolado;0;0;0;4;4
3529807;Diagnose e Terapia;0;0;0;0;0
3529807;Hospital;0;0;0;0;0
3529807;Outros;0;0;2;0;2
3529807;Pronto Atendimento;0;0;1;0;1
3529807;Unidade Básica de Saúde;0;0;3;0;3
3529807;Unidade de Saúde Mental ;0;0;1;0;1
3529807;Unidade Móvel;0;0;0;0;0
3529807;Vigilância em Saúde;0;0;0;0;0
3529906;Clínica;0;0;1;0;1
3529906;Consultório Isolado;0;0;0;2;2
3529906;Diagnose e Terapia;0;0;0;2;2
3529906;Hospital;0;0;0;0;0
3529906;Outros;0;1;3;1;5
3529906;Pronto Atendimento;0;0;1;0;1
3529906;Unidade Básica de Saúde;0;0;10;0;10
3529906;Unidade de Saúde Mental ;0;0;2;0;2
3529906;Unidade Móvel;0;0;0;0;0
3529906;Vigilância em Saúde;0;0;1;0;1
3530003;Clínica;0;0;1;0;1
3530003;Consultório Isolado;0;0;0;1;1
3530003;Diagnose e Terapia;0;0;0;0;0
3530003;Hospital;0;0;0;0;0
3530003;Outros;0;0;2;0;2
3530003;Pronto Atendimento;0;0;0;0;0
3530003;Unidade Básica de Saúde;0;0;1;0;1
3530003;Unidade de Saúde Mental ;0;0;0;0;0
3530003;Unidade Móvel;0;0;0;0;0
3530003;Vigilância em Saúde;0;0;0;0;0
3530102;Clínica;0;0;1;1;2
3530102;Consultório Isolado;0;0;5;52;57
3530102;Diagnose e Terapia;0;0;2;10;12
3530102;Hospital;1;0;0;1;2
3530102;Outros;0;0;4;0;4
3530102;Pronto Atendimento;0;0;1;0;1
3530102;Unidade Básica de Saúde;2;0;8;0;10
3530102;Unidade de Saúde Mental ;0;0;1;0;1
3530102;Unidade Móvel;0;0;0;0;0
3530102;Vigilância em Saúde;0;0;2;0;2
3530201;Clínica;0;0;2;2;4
3530201;Consultório Isolado;0;0;0;11;11
3530201;Diagnose e Terapia;0;0;0;2;2
3530201;Hospital;0;0;0;0;0
3530201;Outros;0;0;3;0;3
3530201;Pronto Atendimento;0;0;1;0;1
3530201;Unidade Básica de Saúde;0;0;10;0;10
3530201;Unidade de Saúde Mental ;0;0;1;0;1
3530201;Unidade Móvel;0;0;0;0;0
3530201;Vigilância em Saúde;0;0;0;0;0
3530300;Clínica;0;0;5;15;20
3530300;Consultório Isolado;1;0;0;109;110
3530300;Diagnose e Terapia;0;0;0;11;11
3530300;Hospital;0;0;0;2;2
3530300;Outros;0;0;2;3;5
3530300;Pronto Atendimento;0;0;1;0;1
3530300;Unidade Básica de Saúde;0;0;8;0;8
3530300;Unidade de Saúde Mental ;0;0;1;0;1
3530300;Unidade Móvel;0;0;1;0;1
3530300;Vigilância em Saúde;0;0;1;0;1
3530409;Clínica;0;0;0;0;0
3530409;Consultório Isolado;0;0;0;0;0
3530409;Diagnose e Terapia;0;0;0;0;0
3530409;Hospital;0;0;0;0;0
3530409;Outros;0;0;1;0;1
3530409;Pronto Atendimento;0;0;0;0;0
3530409;Unidade Básica de Saúde;0;0;1;0;1
3530409;Unidade de Saúde Mental ;0;0;0;0;0
3530409;Unidade Móvel;0;0;0;0;0
3530409;Vigilância em Saúde;0;0;0;0;0
3530508;Clínica;0;0;4;108;112
3530508;Consultório Isolado;0;0;2;125;127
3530508;Diagnose e Terapia;1;0;2;10;13
3530508;Hospital;0;0;0;1;1
3530508;Outros;0;0;5;2;7
3530508;Pronto Atendimento;0;0;2;0;2
3530508;Unidade Básica de Saúde;0;0;18;0;18
3530508;Unidade de Saúde Mental ;0;0;4;0;4
3530508;Unidade Móvel;1;0;1;0;2
3530508;Vigilância em Saúde;0;0;3;0;3
3530607;Clínica;2;0;12;219;233
3530607;Consultório Isolado;0;0;0;267;267
3530607;Diagnose e Terapia;0;0;1;64;65
3530607;Hospital;2;0;2;9;13
3530607;Outros;2;0;7;7;16
3530607;Pronto Atendimento;0;0;3;0;3
3530607;Unidade Básica de Saúde;0;0;39;0;39
3530607;Unidade de Saúde Mental ;0;0;2;0;2
3530607;Unidade Móvel;0;0;12;0;12
3530607;Vigilância em Saúde;1;0;4;0;5
3530706;Clínica;1;0;3;43;47
3530706;Consultório Isolado;0;0;0;305;305
3530706;Diagnose e Terapia;0;0;0;23;23
3530706;Hospital;0;0;2;2;4
3530706;Outros;0;0;6;4;10
3530706;Pronto Atendimento;0;0;2;0;2
3530706;Unidade Básica de Saúde;0;0;25;0;25
3530706;Unidade de Saúde Mental ;0;0;3;0;3
3530706;Unidade Móvel;0;0;3;0;3
3530706;Vigilância em Saúde;0;0;1;0;1
3530805;Clínica;1;0;7;20;28
3530805;Consultório Isolado;0;0;1;220;221
3530805;Diagnose e Terapia;0;0;1;27;28
3530805;Hospital;0;0;0;3;3
3530805;Outros;0;0;3;1;4
3530805;Pronto Atendimento;0;0;2;0;2
3530805;Unidade Básica de Saúde;3;0;14;0;17
3530805;Unidade de Saúde Mental ;0;0;3;0;3
3530805;Unidade Móvel;0;0;2;0;2
3530805;Vigilância em Saúde;0;0;1;0;1
3530904;Clínica;0;0;0;0;0
3530904;Consultório Isolado;0;0;0;0;0
3530904;Diagnose e Terapia;0;0;0;0;0
3530904;Hospital;0;0;0;0;0
3530904;Outros;0;0;2;0;2
3530904;Pronto Atendimento;0;0;0;0;0
3530904;Unidade Básica de Saúde;0;0;2;0;2
3530904;Unidade de Saúde Mental ;0;0;0;0;0
3530904;Unidade Móvel;0;0;0;0;0
3530904;Vigilância em Saúde;0;0;0;0;0
3531001;Clínica;0;0;0;0;0
3531001;Consultório Isolado;0;0;0;1;1
3531001;Diagnose e Terapia;0;0;2;0;2
3531001;Hospital;0;0;0;0;0
3531001;Outros;0;0;2;0;2
3531001;Pronto Atendimento;0;0;0;0;0
3531001;Unidade Básica de Saúde;0;0;2;0;2
3531001;Unidade de Saúde Mental ;0;0;0;0;0
3531001;Unidade Móvel;0;0;0;0;0
3531001;Vigilância em Saúde;0;0;0;0;0
3531100;Clínica;0;0;3;11;14
3531100;Consultório Isolado;0;0;0;8;8
3531100;Diagnose e Terapia;0;0;0;4;4
3531100;Hospital;0;0;1;1;2
3531100;Outros;0;2;3;0;5
3531100;Pronto Atendimento;0;0;2;0;2
3531100;Unidade Básica de Saúde;1;0;10;0;11
3531100;Unidade de Saúde Mental ;0;0;0;0;0
3531100;Unidade Móvel;0;0;4;0;4
3531100;Vigilância em Saúde;0;0;1;0;1
3531209;Clínica;0;0;1;2;3
3531209;Consultório Isolado;0;0;0;7;7
3531209;Diagnose e Terapia;0;0;1;1;2
3531209;Hospital;0;0;0;0;0
3531209;Outros;0;0;2;0;2
3531209;Pronto Atendimento;0;0;1;0;1
3531209;Unidade Básica de Saúde;0;0;3;0;3
3531209;Unidade de Saúde Mental ;0;0;0;0;0
3531209;Unidade Móvel;0;0;0;0;0
3531209;Vigilância em Saúde;0;0;1;0;1
3531308;Clínica;0;0;6;53;59
3531308;Consultório Isolado;0;0;1;161;162
3531308;Diagnose e Terapia;0;0;0;3;3
3531308;Hospital;0;0;0;2;2
3531308;Outros;0;0;3;4;7
3531308;Pronto Atendimento;0;0;1;0;1
3531308;Unidade Básica de Saúde;0;0;10;0;10
3531308;Unidade de Saúde Mental ;0;0;1;0;1
3531308;Unidade Móvel;0;0;3;0;3
3531308;Vigilância em Saúde;0;0;0;0;0
3531407;Clínica;0;0;0;9;9
3531407;Consultório Isolado;0;0;3;36;39
3531407;Diagnose e Terapia;0;0;0;2;2
3531407;Hospital;0;0;0;1;1
3531407;Outros;0;0;1;2;3
3531407;Pronto Atendimento;0;0;0;0;0
3531407;Unidade Básica de Saúde;0;0;6;0;6
3531407;Unidade de Saúde Mental ;0;0;0;0;0
3531407;Unidade Móvel;0;0;1;0;1
3531407;Vigilância em Saúde;0;0;0;0;0
3531506;Clínica;0;0;1;1;2
3531506;Consultório Isolado;0;0;0;27;27
3531506;Diagnose e Terapia;0;0;0;7;7
3531506;Hospital;0;0;0;2;2
3531506;Outros;0;0;3;1;4
3531506;Pronto Atendimento;0;0;1;0;1
3531506;Unidade Básica de Saúde;0;0;7;2;9
3531506;Unidade de Saúde Mental ;0;0;0;0;0
3531506;Unidade Móvel;0;0;0;0;0
3531506;Vigilância em Saúde;0;0;0;0;0
3531605;Clínica;0;0;0;0;0
3531605;Consultório Isolado;0;0;0;0;0
3531605;Diagnose e Terapia;0;0;1;0;1
3531605;Hospital;0;0;0;0;0
3531605;Outros;0;0;2;0;2
3531605;Pronto Atendimento;0;0;0;0;0
3531605;Unidade Básica de Saúde;0;0;2;0;2
3531605;Unidade de Saúde Mental ;0;0;0;0;0
3531605;Unidade Móvel;0;0;0;0;0
3531605;Vigilância em Saúde;0;0;0;0;0
3531704;Clínica;0;0;0;1;1
3531704;Consultório Isolado;0;0;0;2;2
3531704;Diagnose e Terapia;0;0;0;0;0
3531704;Hospital;0;0;0;0;0
3531704;Outros;0;0;1;0;1
3531704;Pronto Atendimento;0;0;0;0;0
3531704;Unidade Básica de Saúde;0;0;3;0;3
3531704;Unidade de Saúde Mental ;0;0;0;0;0
3531704;Unidade Móvel;0;0;0;0;0
3531704;Vigilância em Saúde;0;0;0;0;0
3531803;Clínica;0;0;3;5;8
3531803;Consultório Isolado;0;0;0;45;45
3531803;Diagnose e Terapia;0;0;0;9;9
3531803;Hospital;0;0;0;1;1
3531803;Outros;0;0;2;0;2
3531803;Pronto Atendimento;0;0;1;0;1
3531803;Unidade Básica de Saúde;0;0;12;0;12
3531803;Unidade de Saúde Mental ;0;0;1;0;1
3531803;Unidade Móvel;0;0;1;0;1
3531803;Vigilância em Saúde;0;0;2;0;2
3531902;Clínica;0;0;3;5;8
3531902;Consultório Isolado;0;0;0;47;47
3531902;Diagnose e Terapia;0;0;0;12;12
3531902;Hospital;0;0;0;1;1
3531902;Outros;0;0;2;1;3
3531902;Pronto Atendimento;0;0;1;0;1
3531902;Unidade Básica de Saúde;0;0;10;0;10
3531902;Unidade de Saúde Mental ;0;0;1;0;1
3531902;Unidade Móvel;0;0;0;0;0
3531902;Vigilância em Saúde;0;0;1;0;1
3532009;Clínica;0;0;1;2;3
3532009;Consultório Isolado;0;0;0;4;4
3532009;Diagnose e Terapia;0;0;0;6;6
3532009;Hospital;0;0;1;2;3
3532009;Outros;0;0;1;0;1
3532009;Pronto Atendimento;0;0;0;0;0
3532009;Unidade Básica de Saúde;0;0;9;0;9
3532009;Unidade de Saúde Mental ;0;0;1;0;1
3532009;Unidade Móvel;0;0;0;0;0
3532009;Vigilância em Saúde;0;0;1;0;1
3532058;Clínica;0;0;0;1;1
3532058;Consultório Isolado;0;0;0;1;1
3532058;Diagnose e Terapia;0;0;0;0;0
3532058;Hospital;0;0;0;0;0
3532058;Outros;0;0;2;0;2
3532058;Pronto Atendimento;0;0;0;0;0
3532058;Unidade Básica de Saúde;0;0;2;0;2
3532058;Unidade de Saúde Mental ;0;0;0;0;0
3532058;Unidade Móvel;0;0;0;0;0
3532058;Vigilância em Saúde;0;0;1;0;1
3532108;Clínica;0;0;0;1;1
3532108;Consultório Isolado;0;0;0;1;1
3532108;Diagnose e Terapia;0;0;0;2;2
3532108;Hospital;0;0;0;1;1
3532108;Outros;0;0;2;0;2
3532108;Pronto Atendimento;0;0;0;0;0
3532108;Unidade Básica de Saúde;0;0;2;0;2
3532108;Unidade de Saúde Mental ;0;0;0;0;0
3532108;Unidade Móvel;0;0;0;0;0
3532108;Vigilância em Saúde;0;0;1;0;1
3532157;Clínica;0;0;0;0;0
3532157;Consultório Isolado;0;0;0;0;0
3532157;Diagnose e Terapia;0;0;1;0;1
3532157;Hospital;0;0;0;0;0
3532157;Outros;0;0;2;0;2
3532157;Pronto Atendimento;0;0;0;0;0
3532157;Unidade Básica de Saúde;0;0;2;0;2
3532157;Unidade de Saúde Mental ;0;0;0;0;0
3532157;Unidade Móvel;0;0;0;0;0
3532157;Vigilância em Saúde;0;0;0;0;0
3532207;Clínica;0;0;1;1;2
3532207;Consultório Isolado;0;0;0;0;0
3532207;Diagnose e Terapia;0;0;0;0;0
3532207;Hospital;0;0;0;0;0
3532207;Outros;0;0;2;0;2
3532207;Pronto Atendimento;0;0;0;0;0
3532207;Unidade Básica de Saúde;0;0;2;0;2
3532207;Unidade de Saúde Mental ;0;0;0;0;0
3532207;Unidade Móvel;0;0;0;0;0
3532207;Vigilância em Saúde;0;0;0;0;0
3532306;Clínica;0;0;0;0;0
3532306;Consultório Isolado;0;0;0;0;0
3532306;Diagnose e Terapia;0;0;0;0;0
3532306;Hospital;0;0;0;0;0
3532306;Outros;0;0;3;0;3
3532306;Pronto Atendimento;0;0;0;0;0
3532306;Unidade Básica de Saúde;0;0;3;0;3
3532306;Unidade de Saúde Mental ;0;0;0;0;0
3532306;Unidade Móvel;0;0;1;0;1
3532306;Vigilância em Saúde;0;0;0;0;0
3532405;Clínica;0;0;0;5;5
3532405;Consultório Isolado;0;0;0;1;1
3532405;Diagnose e Terapia;0;0;0;2;2
3532405;Hospital;0;0;1;0;1
3532405;Outros;0;0;1;0;1
3532405;Pronto Atendimento;0;0;0;0;0
3532405;Unidade Básica de Saúde;0;0;2;0;2
3532405;Unidade de Saúde Mental ;0;0;0;0;0
3532405;Unidade Móvel;0;0;1;0;1
3532405;Vigilância em Saúde;0;0;0;0;0
3532504;Clínica;0;0;0;1;1
3532504;Consultório Isolado;0;0;0;7;7
3532504;Diagnose e Terapia;0;0;0;1;1
3532504;Hospital;0;0;0;1;1
3532504;Outros;0;0;1;0;1
3532504;Pronto Atendimento;0;0;0;0;0
3532504;Unidade Básica de Saúde;0;0;4;0;4
3532504;Unidade de Saúde Mental ;0;0;0;0;0
3532504;Unidade Móvel;0;0;1;0;1
3532504;Vigilância em Saúde;0;0;0;0;0
3532603;Clínica;0;0;0;3;3
3532603;Consultório Isolado;0;0;0;28;28
3532603;Diagnose e Terapia;0;0;1;4;5
3532603;Hospital;0;0;0;2;2
3532603;Outros;0;0;1;0;1
3532603;Pronto Atendimento;0;0;0;0;0
3532603;Unidade Básica de Saúde;0;0;5;0;5
3532603;Unidade de Saúde Mental ;0;0;0;0;0
3532603;Unidade Móvel;0;0;1;1;2
3532603;Vigilância em Saúde;0;0;0;0;0
3532702;Clínica;0;0;0;0;0
3532702;Consultório Isolado;0;0;0;2;2
3532702;Diagnose e Terapia;0;0;0;0;0
3532702;Hospital;0;0;0;0;0
3532702;Outros;0;0;1;0;1
3532702;Pronto Atendimento;0;0;0;0;0
3532702;Unidade Básica de Saúde;0;0;1;0;1
3532702;Unidade de Saúde Mental ;0;0;0;0;0
3532702;Unidade Móvel;0;0;0;0;0
3532702;Vigilância em Saúde;0;0;0;0;0
3532801;Clínica;0;0;1;1;2
3532801;Consultório Isolado;0;0;0;1;1
3532801;Diagnose e Terapia;0;0;0;1;1
3532801;Hospital;0;0;0;0;0
3532801;Outros;0;0;1;0;1
3532801;Pronto Atendimento;0;0;0;0;0
3532801;Unidade Básica de Saúde;0;0;2;0;2
3532801;Unidade de Saúde Mental ;0;0;0;0;0
3532801;Unidade Móvel;0;0;0;0;0
3532801;Vigilância em Saúde;0;0;0;0;0
3532827;Clínica;0;0;0;0;0
3532827;Consultório Isolado;0;0;0;0;0
3532827;Diagnose e Terapia;0;0;0;0;0
3532827;Hospital;0;0;0;0;0
3532827;Outros;0;0;3;0;3
3532827;Pronto Atendimento;0;0;0;0;0
3532827;Unidade Básica de Saúde;0;0;5;0;5
3532827;Unidade de Saúde Mental ;0;0;0;0;0
3532827;Unidade Móvel;0;0;1;0;1
3532827;Vigilância em Saúde;0;0;1;0;1
3532843;Clínica;0;0;1;0;1
3532843;Consultório Isolado;0;0;0;0;0
3532843;Diagnose e Terapia;0;0;0;0;0
3532843;Hospital;0;0;0;0;0
3532843;Outros;0;0;1;0;1
3532843;Pronto Atendimento;0;0;0;0;0
3532843;Unidade Básica de Saúde;0;0;2;0;2
3532843;Unidade de Saúde Mental ;0;0;0;0;0
3532843;Unidade Móvel;0;0;0;0;0
3532843;Vigilância em Saúde;0;0;0;0;0
3532868;Clínica;0;0;0;0;0
3532868;Consultório Isolado;0;0;0;0;0
3532868;Diagnose e Terapia;0;0;0;0;0
3532868;Hospital;0;0;0;0;0
3532868;Outros;0;0;2;0;2
3532868;Pronto Atendimento;0;0;0;0;0
3532868;Unidade Básica de Saúde;0;0;1;0;1
3532868;Unidade de Saúde Mental ;0;0;0;0;0
3532868;Unidade Móvel;0;0;0;0;0
3532868;Vigilância em Saúde;0;0;1;0;1
3532900;Clínica;0;0;0;2;2
3532900;Consultório Isolado;0;0;0;12;12
3532900;Diagnose e Terapia;0;0;0;1;1
3532900;Hospital;0;0;0;1;1
3532900;Outros;0;0;1;0;1
3532900;Pronto Atendimento;0;0;1;0;1
3532900;Unidade Básica de Saúde;0;0;5;0;5
3532900;Unidade de Saúde Mental ;0;0;0;0;0
3532900;Unidade Móvel;0;0;0;0;0
3532900;Vigilância em Saúde;0;0;0;0;0
3533007;Clínica;0;0;0;8;8
3533007;Consultório Isolado;0;0;0;12;12
3533007;Diagnose e Terapia;0;0;0;1;1
3533007;Hospital;0;0;0;1;1
3533007;Outros;0;0;2;0;2
3533007;Pronto Atendimento;0;0;1;0;1
3533007;Unidade Básica de Saúde;0;0;8;0;8
3533007;Unidade de Saúde Mental ;0;0;1;0;1
3533007;Unidade Móvel;0;0;1;0;1
3533007;Vigilância em Saúde;0;0;0;0;0
3533106;Clínica;0;0;1;0;1
3533106;Consultório Isolado;0;0;0;0;0
3533106;Diagnose e Terapia;0;0;0;0;0
3533106;Hospital;0;0;0;0;0
3533106;Outros;0;0;2;0;2
3533106;Pronto Atendimento;0;0;0;0;0
3533106;Unidade Básica de Saúde;0;0;1;0;1
3533106;Unidade de Saúde Mental ;0;0;0;0;0
3533106;Unidade Móvel;0;0;0;0;0
3533106;Vigilância em Saúde;0;0;0;0;0
3533205;Clínica;0;0;1;0;1
3533205;Consultório Isolado;1;0;0;4;5
3533205;Diagnose e Terapia;0;0;0;1;1
3533205;Hospital;0;0;0;0;0
3533205;Outros;0;0;2;0;2
3533205;Pronto Atendimento;0;0;0;0;0
3533205;Unidade Básica de Saúde;0;0;2;0;2
3533205;Unidade de Saúde Mental ;0;0;0;0;0
3533205;Unidade Móvel;0;0;0;0;0
3533205;Vigilância em Saúde;0;0;0;0;0
3533254;Clínica;0;0;1;0;1
3533254;Consultório Isolado;0;0;0;0;0
3533254;Diagnose e Terapia;0;0;0;1;1
3533254;Hospital;0;0;0;0;0
3533254;Outros;0;0;1;0;1
3533254;Pronto Atendimento;0;0;1;0;1
3533254;Unidade Básica de Saúde;0;0;1;0;1
3533254;Unidade de Saúde Mental ;0;0;0;0;0
3533254;Unidade Móvel;0;0;0;0;0
3533254;Vigilância em Saúde;0;0;0;0;0
3533304;Clínica;0;0;0;0;0
3533304;Consultório Isolado;0;0;0;1;1
3533304;Diagnose e Terapia;0;0;0;1;1
3533304;Hospital;0;0;0;0;0
3533304;Outros;0;0;1;0;1
3533304;Pronto Atendimento;0;0;0;0;0
3533304;Unidade Básica de Saúde;0;0;1;0;1
3533304;Unidade de Saúde Mental ;0;0;0;0;0
3533304;Unidade Móvel;0;0;0;0;0
3533304;Vigilância em Saúde;0;0;0;0;0
3533403;Clínica;0;0;2;4;6
3533403;Consultório Isolado;0;0;0;74;74
3533403;Diagnose e Terapia;0;0;0;5;5
3533403;Hospital;0;0;2;0;2
3533403;Outros;0;0;3;0;3
3533403;Pronto Atendimento;0;0;0;0;0
3533403;Unidade Básica de Saúde;0;0;7;0;7
3533403;Unidade de Saúde Mental ;0;0;1;0;1
3533403;Unidade Móvel;0;0;0;0;0
3533403;Vigilância em Saúde;0;0;0;0;0
3533502;Clínica;0;0;2;26;28
3533502;Consultório Isolado;0;0;0;74;74
3533502;Diagnose e Terapia;0;0;2;6;8
3533502;Hospital;0;0;0;1;1
3533502;Outros;0;0;1;0;1
3533502;Pronto Atendimento;0;0;0;0;0
3533502;Unidade Básica de Saúde;0;0;9;0;9
3533502;Unidade de Saúde Mental ;0;0;1;0;1
3533502;Unidade Móvel;0;0;0;0;0
3533502;Vigilância em Saúde;0;0;0;0;0
3533601;Clínica;0;0;0;0;0
3533601;Consultório Isolado;0;0;0;12;12
3533601;Diagnose e Terapia;0;0;1;7;8
3533601;Hospital;0;0;0;1;1
3533601;Outros;0;0;1;0;1
3533601;Pronto Atendimento;0;0;0;1;1
3533601;Unidade Básica de Saúde;0;0;5;0;5
3533601;Unidade de Saúde Mental ;0;0;0;0;0
3533601;Unidade Móvel;0;0;0;0;0
3533601;Vigilância em Saúde;0;0;0;0;0
3533700;Clínica;0;0;0;0;0
3533700;Consultório Isolado;0;0;0;0;0
3533700;Diagnose e Terapia;0;0;0;0;0
3533700;Hospital;0;0;0;0;0
3533700;Outros;0;0;1;0;1
3533700;Pronto Atendimento;0;0;0;0;0
3533700;Unidade Básica de Saúde;0;0;3;0;3
3533700;Unidade de Saúde Mental ;0;0;0;0;0
3533700;Unidade Móvel;0;0;0;0;0
3533700;Vigilância em Saúde;0;0;0;0;0
3533809;Clínica;0;0;0;0;0
3533809;Consultório Isolado;0;0;0;0;0
3533809;Diagnose e Terapia;0;0;0;0;0
3533809;Hospital;0;0;0;0;0
3533809;Outros;0;0;1;0;1
3533809;Pronto Atendimento;0;0;0;0;0
3533809;Unidade Básica de Saúde;0;0;3;0;3
3533809;Unidade de Saúde Mental ;0;0;0;0;0
3533809;Unidade Móvel;0;0;0;0;0
3533809;Vigilância em Saúde;0;0;0;0;0
3533908;Clínica;0;0;4;26;30
3533908;Consultório Isolado;0;0;0;121;121
3533908;Diagnose e Terapia;0;0;3;14;17
3533908;Hospital;0;0;0;2;2
3533908;Outros;0;0;5;0;5
3533908;Pronto Atendimento;0;0;1;2;3
3533908;Unidade Básica de Saúde;0;0;9;0;9
3533908;Unidade de Saúde Mental ;0;0;1;0;1
3533908;Unidade Móvel;0;0;2;0;2
3533908;Vigilância em Saúde;0;0;0;0;0
3534005;Clínica;0;0;1;0;1
3534005;Consultório Isolado;0;0;0;1;1
3534005;Diagnose e Terapia;0;0;0;1;1
3534005;Hospital;0;0;0;0;0
3534005;Outros;0;0;2;0;2
3534005;Pronto Atendimento;0;0;0;0;0
3534005;Unidade Básica de Saúde;0;0;2;0;2
3534005;Unidade de Saúde Mental ;0;0;0;0;0
3534005;Unidade Móvel;0;0;0;0;0
3534005;Vigilância em Saúde;0;0;0;0;0
3534104;Clínica;0;0;0;0;0
3534104;Consultório Isolado;0;0;0;12;12
3534104;Diagnose e Terapia;0;0;0;0;0
3534104;Hospital;0;0;0;0;0
3534104;Outros;0;0;2;0;2
3534104;Pronto Atendimento;0;0;0;0;0
3534104;Unidade Básica de Saúde;0;0;3;0;3
3534104;Unidade de Saúde Mental ;0;0;0;0;0
3534104;Unidade Móvel;0;0;0;0;0
3534104;Vigilância em Saúde;0;0;0;0;0
3534203;Clínica;0;0;1;1;2
3534203;Consultório Isolado;0;0;0;9;9
3534203;Diagnose e Terapia;0;0;0;2;2
3534203;Hospital;0;0;0;0;0
3534203;Outros;0;0;1;0;1
3534203;Pronto Atendimento;0;0;0;0;0
3534203;Unidade Básica de Saúde;0;0;1;0;1
3534203;Unidade de Saúde Mental ;0;0;1;0;1
3534203;Unidade Móvel;0;0;1;0;1
3534203;Vigilância em Saúde;0;0;0;0;0
3534302;Clínica;0;0;7;46;53
3534302;Consultório Isolado;0;0;0;140;140
3534302;Diagnose e Terapia;0;0;2;9;11
3534302;Hospital;0;0;0;1;1
3534302;Outros;0;0;2;2;4
3534302;Pronto Atendimento;0;0;0;2;2
3534302;Unidade Básica de Saúde;0;0;9;1;10
3534302;Unidade de Saúde Mental ;0;0;2;0;2
3534302;Unidade Móvel;1;0;1;0;2
3534302;Vigilância em Saúde;0;0;1;0;1
3534401;Clínica;1;0;15;377;393
3534401;Consultório Isolado;0;0;3;655;658
3534401;Diagnose e Terapia;1;0;1;68;70
3534401;Hospital;1;0;3;8;12
3534401;Outros;2;0;9;11;22
3534401;Pronto Atendimento;0;0;10;4;14
3534401;Unidade Básica de Saúde;1;0;36;0;37
3534401;Unidade de Saúde Mental ;0;0;3;0;3
3534401;Unidade Móvel;0;0;12;1;13
3534401;Vigilância em Saúde;1;0;4;0;5
3534500;Clínica;0;0;0;0;0
3534500;Consultório Isolado;0;0;0;0;0
3534500;Diagnose e Terapia;0;0;0;0;0
3534500;Hospital;0;0;0;0;0
3534500;Outros;0;0;2;0;2
3534500;Pronto Atendimento;0;0;0;0;0
3534500;Unidade Básica de Saúde;0;0;1;0;1
3534500;Unidade de Saúde Mental ;0;0;0;0;0
3534500;Unidade Móvel;0;0;1;0;1
3534500;Vigilância em Saúde;0;0;0;0;0
3534609;Clínica;0;0;2;14;16
3534609;Consultório Isolado;0;0;0;43;43
3534609;Diagnose e Terapia;0;0;0;17;17
3534609;Hospital;0;0;0;1;1
3534609;Outros;0;0;3;3;6
3534609;Pronto Atendimento;0;0;0;0;0
3534609;Unidade Básica de Saúde;1;0;10;0;11
3534609;Unidade de Saúde Mental ;0;0;1;0;1
3534609;Unidade Móvel;0;0;1;0;1
3534609;Vigilância em Saúde;0;0;0;0;0
3534708;Clínica;0;0;4;16;20
3534708;Consultório Isolado;0;0;0;450;450
3534708;Diagnose e Terapia;0;0;2;60;62
3534708;Hospital;1;0;1;5;7
3534708;Outros;0;0;7;4;11
3534708;Pronto Atendimento;0;0;1;0;1
3534708;Unidade Básica de Saúde;0;0;20;0;20
3534708;Unidade de Saúde Mental ;0;0;2;0;2
3534708;Unidade Móvel;0;0;3;1;4
3534708;Vigilância em Saúde;0;0;2;0;2
3534757;Clínica;0;0;1;0;1
3534757;Consultório Isolado;0;0;0;24;24
3534757;Diagnose e Terapia;0;0;0;2;2
3534757;Hospital;0;0;1;0;1
3534757;Outros;0;0;1;0;1
3534757;Pronto Atendimento;0;0;0;0;0
3534757;Unidade Básica de Saúde;0;0;4;0;4
3534757;Unidade de Saúde Mental ;0;0;0;0;0
3534757;Unidade Móvel;0;0;0;0;0
3534757;Vigilância em Saúde;0;0;1;0;1
3534807;Clínica;0;0;0;1;1
3534807;Consultório Isolado;0;0;0;2;2
3534807;Diagnose e Terapia;0;0;2;1;3
3534807;Hospital;0;0;0;0;0
3534807;Outros;0;0;1;0;1
3534807;Pronto Atendimento;0;0;0;0;0
3534807;Unidade Básica de Saúde;0;0;3;0;3
3534807;Unidade de Saúde Mental ;0;0;0;0;0
3534807;Unidade Móvel;0;0;0;0;0
3534807;Vigilância em Saúde;0;0;0;0;0
3534906;Clínica;0;0;0;0;0
3534906;Consultório Isolado;0;0;0;19;19
3534906;Diagnose e Terapia;0;0;0;2;2
3534906;Hospital;0;0;0;1;1
3534906;Outros;0;0;3;0;3
3534906;Pronto Atendimento;0;0;1;0;1
3534906;Unidade Básica de Saúde;4;0;4;0;8
3534906;Unidade de Saúde Mental ;0;0;1;0;1
3534906;Unidade Móvel;0;0;0;0;0
3534906;Vigilância em Saúde;0;0;1;0;1
3535002;Clínica;0;0;0;1;1
3535002;Consultório Isolado;0;0;0;12;12
3535002;Diagnose e Terapia;0;0;0;5;5
3535002;Hospital;0;0;0;0;0
3535002;Outros;0;0;1;0;1
3535002;Pronto Atendimento;0;0;0;0;0
3535002;Unidade Básica de Saúde;0;0;4;0;4
3535002;Unidade de Saúde Mental ;0;0;0;0;0
3535002;Unidade Móvel;0;0;1;0;1
3535002;Vigilância em Saúde;0;0;0;0;0
3535101;Clínica;0;0;1;1;2
3535101;Consultório Isolado;0;0;0;11;11
3535101;Diagnose e Terapia;0;0;0;6;6
3535101;Hospital;0;0;0;0;0
3535101;Outros;0;0;2;0;2
3535101;Pronto Atendimento;0;0;0;0;0
3535101;Unidade Básica de Saúde;0;0;3;0;3
3535101;Unidade de Saúde Mental ;0;0;0;0;0
3535101;Unidade Móvel;0;0;0;0;0
3535101;Vigilância em Saúde;0;0;0;0;0
3535200;Clínica;0;0;0;1;1
3535200;Consultório Isolado;0;0;0;7;7
3535200;Diagnose e Terapia;0;0;0;1;1
3535200;Hospital;0;0;0;1;1
3535200;Outros;0;0;1;0;1
3535200;Pronto Atendimento;0;0;0;0;0
3535200;Unidade Básica de Saúde;0;0;7;0;7
3535200;Unidade de Saúde Mental ;0;0;0;0;0
3535200;Unidade Móvel;0;0;1;0;1
3535200;Vigilância em Saúde;0;0;0;0;0
3535309;Clínica;0;0;1;3;4
3535309;Consultório Isolado;0;0;0;38;38
3535309;Diagnose e Terapia;0;0;0;6;6
3535309;Hospital;0;0;0;1;1
3535309;Outros;0;0;5;0;5
3535309;Pronto Atendimento;0;0;0;0;0
3535309;Unidade Básica de Saúde;0;0;6;0;6
3535309;Unidade de Saúde Mental ;0;0;0;0;0
3535309;Unidade Móvel;0;0;1;0;1
3535309;Vigilância em Saúde;0;0;1;0;1
3535408;Clínica;0;0;1;1;2
3535408;Consultório Isolado;0;0;1;6;7
3535408;Diagnose e Terapia;0;0;1;2;3
3535408;Hospital;0;0;0;1;1
3535408;Outros;0;0;1;0;1
3535408;Pronto Atendimento;0;0;1;0;1
3535408;Unidade Básica de Saúde;0;0;5;0;5
3535408;Unidade de Saúde Mental ;0;0;1;0;1
3535408;Unidade Móvel;0;0;0;0;0
3535408;Vigilância em Saúde;0;0;0;0;0
3535507;Clínica;0;0;3;6;9
3535507;Consultório Isolado;0;0;0;99;99
3535507;Diagnose e Terapia;0;0;0;11;11
3535507;Hospital;0;0;0;1;1
3535507;Outros;0;0;6;0;6
3535507;Pronto Atendimento;0;0;0;0;0
3535507;Unidade Básica de Saúde;1;0;14;0;15
3535507;Unidade de Saúde Mental ;0;0;1;0;1
3535507;Unidade Móvel;0;0;2;0;2
3535507;Vigilância em Saúde;0;0;0;0;0
3535606;Clínica;0;0;0;0;0
3535606;Consultório Isolado;0;0;0;7;7
3535606;Diagnose e Terapia;0;0;0;1;1
3535606;Hospital;0;0;0;1;1
3535606;Outros;0;0;1;0;1
3535606;Pronto Atendimento;0;0;1;0;1
3535606;Unidade Básica de Saúde;0;0;9;0;9
3535606;Unidade de Saúde Mental ;0;0;1;0;1
3535606;Unidade Móvel;0;0;1;1;2
3535606;Vigilância em Saúde;0;0;0;0;0
3535705;Clínica;0;0;0;0;0
3535705;Consultório Isolado;0;0;0;5;5
3535705;Diagnose e Terapia;0;0;0;3;3
3535705;Hospital;0;0;0;0;0
3535705;Outros;0;0;2;0;2
3535705;Pronto Atendimento;0;0;0;0;0
3535705;Unidade Básica de Saúde;0;0;3;0;3
3535705;Unidade de Saúde Mental ;0;0;0;0;0
3535705;Unidade Móvel;0;0;0;0;0
3535705;Vigilância em Saúde;0;0;0;0;0
3535804;Clínica;0;0;0;1;1
3535804;Consultório Isolado;0;0;0;25;25
3535804;Diagnose e Terapia;0;0;0;4;4
3535804;Hospital;0;0;1;0;1
3535804;Outros;0;0;1;13;14
3535804;Pronto Atendimento;0;0;0;0;0
3535804;Unidade Básica de Saúde;0;0;6;0;6
3535804;Unidade de Saúde Mental ;0;0;1;0;1
3535804;Unidade Móvel;0;0;1;0;1
3535804;Vigilância em Saúde;0;0;1;0;1
3535903;Clínica;0;0;0;0;0
3535903;Consultório Isolado;0;0;0;1;1
3535903;Diagnose e Terapia;0;0;0;0;0
3535903;Hospital;0;0;0;1;1
3535903;Outros;0;0;1;0;1
3535903;Pronto Atendimento;0;0;0;0;0
3535903;Unidade Básica de Saúde;0;0;1;0;1
3535903;Unidade de Saúde Mental ;0;0;0;0;0
3535903;Unidade Móvel;0;0;0;0;0
3535903;Vigilância em Saúde;0;0;0;0;0
3536000;Clínica;0;0;0;0;0
3536000;Consultório Isolado;0;0;0;2;2
3536000;Diagnose e Terapia;0;0;0;0;0
3536000;Hospital;0;0;0;1;1
3536000;Outros;0;0;3;0;3
3536000;Pronto Atendimento;0;0;0;0;0
3536000;Unidade Básica de Saúde;0;0;4;0;4
3536000;Unidade de Saúde Mental ;0;0;0;0;0
3536000;Unidade Móvel;0;0;0;0;0
3536000;Vigilância em Saúde;0;0;1;0;1
3536109;Clínica;0;0;0;0;0
3536109;Consultório Isolado;0;0;0;1;1
3536109;Diagnose e Terapia;0;0;0;0;0
3536109;Hospital;0;0;0;0;0
3536109;Outros;0;0;1;0;1
3536109;Pronto Atendimento;0;0;0;0;0
3536109;Unidade Básica de Saúde;0;0;1;0;1
3536109;Unidade de Saúde Mental ;0;0;0;0;0
3536109;Unidade Móvel;0;0;1;0;1
3536109;Vigilância em Saúde;0;0;1;0;1
3536208;Clínica;2;0;1;2;5
3536208;Consultório Isolado;0;0;0;9;9
3536208;Diagnose e Terapia;0;0;0;6;6
3536208;Hospital;0;0;1;0;1
3536208;Outros;0;0;1;0;1
3536208;Pronto Atendimento;0;0;0;0;0
3536208;Unidade Básica de Saúde;0;0;9;0;9
3536208;Unidade de Saúde Mental ;0;0;1;0;1
3536208;Unidade Móvel;0;0;1;0;1
3536208;Vigilância em Saúde;0;0;0;0;0
3536257;Clínica;0;0;0;0;0
3536257;Consultório Isolado;0;0;0;0;0
3536257;Diagnose e Terapia;0;0;0;0;0
3536257;Hospital;0;0;0;0;0
3536257;Outros;0;0;1;0;1
3536257;Pronto Atendimento;0;0;0;0;0
3536257;Unidade Básica de Saúde;0;0;1;0;1
3536257;Unidade de Saúde Mental ;0;0;0;0;0
3536257;Unidade Móvel;0;0;0;0;0
3536257;Vigilância em Saúde;0;0;0;0;0
3536307;Clínica;0;0;1;1;2
3536307;Consultório Isolado;0;0;1;3;4
3536307;Diagnose e Terapia;0;0;1;2;3
3536307;Hospital;0;0;0;1;1
3536307;Outros;0;0;1;0;1
3536307;Pronto Atendimento;0;0;0;0;0
3536307;Unidade Básica de Saúde;0;0;6;0;6
3536307;Unidade de Saúde Mental ;0;0;1;0;1
3536307;Unidade Móvel;0;0;1;0;1
3536307;Vigilância em Saúde;0;0;0;0;0
3536406;Clínica;0;0;0;0;0
3536406;Consultório Isolado;0;0;0;0;0
3536406;Diagnose e Terapia;0;0;1;1;2
3536406;Hospital;0;0;0;0;0
3536406;Outros;0;0;1;0;1
3536406;Pronto Atendimento;0;0;0;0;0
3536406;Unidade Básica de Saúde;0;0;3;0;3
3536406;Unidade de Saúde Mental ;0;0;0;0;0
3536406;Unidade Móvel;0;0;0;0;0
3536406;Vigilância em Saúde;0;0;1;0;1
3536505;Clínica;0;0;8;42;50
3536505;Consultório Isolado;0;0;0;121;121
3536505;Diagnose e Terapia;0;0;0;17;17
3536505;Hospital;0;0;1;0;1
3536505;Outros;0;0;5;0;5
3536505;Pronto Atendimento;0;0;0;2;2
3536505;Unidade Básica de Saúde;0;0;12;0;12
3536505;Unidade de Saúde Mental ;0;0;2;0;2
3536505;Unidade Móvel;0;0;1;1;2
3536505;Vigilância em Saúde;0;0;2;0;2
3536570;Clínica;0;0;0;0;0
3536570;Consultório Isolado;0;0;0;0;0
3536570;Diagnose e Terapia;0;0;0;0;0
3536570;Hospital;0;0;0;0;0
3536570;Outros;0;0;2;0;2
3536570;Pronto Atendimento;0;0;0;0;0
3536570;Unidade Básica de Saúde;0;0;1;0;1
3536570;Unidade de Saúde Mental ;0;0;0;0;0
3536570;Unidade Móvel;0;0;0;0;0
3536570;Vigilância em Saúde;0;0;0;0;0
3536604;Clínica;0;0;0;1;1
3536604;Consultório Isolado;0;0;0;0;0
3536604;Diagnose e Terapia;0;0;1;1;2
3536604;Hospital;0;0;0;1;1
3536604;Outros;0;0;1;0;1
3536604;Pronto Atendimento;0;0;0;0;0
3536604;Unidade Básica de Saúde;1;0;1;0;2
3536604;Unidade de Saúde Mental ;0;0;0;0;0
3536604;Unidade Móvel;0;0;1;0;1
3536604;Vigilância em Saúde;0;0;0;0;0
3536703;Clínica;0;0;4;1;5
3536703;Consultório Isolado;0;0;0;57;57
3536703;Diagnose e Terapia;0;0;0;9;9
3536703;Hospital;0;0;0;2;2
3536703;Outros;0;0;2;1;3
3536703;Pronto Atendimento;0;0;0;0;0
3536703;Unidade Básica de Saúde;0;0;13;0;13
3536703;Unidade de Saúde Mental ;0;0;1;0;1
3536703;Unidade Móvel;0;0;1;0;1
3536703;Vigilância em Saúde;0;0;0;0;0
3536802;Clínica;0;0;0;1;1
3536802;Consultório Isolado;0;0;0;0;0
3536802;Diagnose e Terapia;0;0;0;0;0
3536802;Hospital;0;0;0;0;0
3536802;Outros;0;0;2;0;2
3536802;Pronto Atendimento;0;0;0;0;0
3536802;Unidade Básica de Saúde;0;0;3;0;3
3536802;Unidade de Saúde Mental ;0;0;0;0;0
3536802;Unidade Móvel;0;0;1;0;1
3536802;Vigilância em Saúde;0;0;0;0;0
3536901;Clínica;0;0;0;0;0
3536901;Consultório Isolado;0;0;0;0;0
3536901;Diagnose e Terapia;0;0;0;0;0
3536901;Hospital;0;0;0;0;0
3536901;Outros;0;0;2;0;2
3536901;Pronto Atendimento;0;0;0;0;0
3536901;Unidade Básica de Saúde;0;0;3;0;3
3536901;Unidade de Saúde Mental ;0;0;0;0;0
3536901;Unidade Móvel;0;0;0;0;0
3536901;Vigilância em Saúde;0;0;0;0;0
3537008;Clínica;0;0;3;0;3
3537008;Consultório Isolado;0;0;0;10;10
3537008;Diagnose e Terapia;0;0;0;4;4
3537008;Hospital;0;0;0;1;1
3537008;Outros;0;0;1;1;2
3537008;Pronto Atendimento;0;0;0;0;0
3537008;Unidade Básica de Saúde;0;0;8;0;8
3537008;Unidade de Saúde Mental ;0;0;0;0;0
3537008;Unidade Móvel;0;0;1;0;1
3537008;Vigilância em Saúde;0;0;1;0;1
3537107;Clínica;0;0;1;9;10
3537107;Consultório Isolado;0;0;0;40;40
3537107;Diagnose e Terapia;0;0;0;15;15
3537107;Hospital;0;0;2;1;3
3537107;Outros;0;0;2;0;2
3537107;Pronto Atendimento;0;0;0;0;0
3537107;Unidade Básica de Saúde;0;0;10;0;10
3537107;Unidade de Saúde Mental ;0;0;1;0;1
3537107;Unidade Móvel;0;0;0;0;0
3537107;Vigilância em Saúde;0;0;0;0;0
3537156;Clínica;0;0;0;0;0
3537156;Consultório Isolado;0;0;0;3;3
3537156;Diagnose e Terapia;0;0;0;4;4
3537156;Hospital;0;0;0;0;0
3537156;Outros;0;0;3;0;3
3537156;Pronto Atendimento;0;0;0;0;0
3537156;Unidade Básica de Saúde;0;0;3;0;3
3537156;Unidade de Saúde Mental ;0;0;0;0;0
3537156;Unidade Móvel;0;0;0;0;0
3537156;Vigilância em Saúde;0;0;0;0;0
3537206;Clínica;0;0;0;2;2
3537206;Consultório Isolado;0;0;1;1;2
3537206;Diagnose e Terapia;0;0;0;0;0
3537206;Hospital;0;0;0;0;0
3537206;Outros;0;0;3;0;3
3537206;Pronto Atendimento;0;0;0;0;0
3537206;Unidade Básica de Saúde;0;0;7;0;7
3537206;Unidade de Saúde Mental ;0;0;0;0;0
3537206;Unidade Móvel;0;0;1;0;1
3537206;Vigilância em Saúde;0;0;1;0;1
3537305;Clínica;0;0;4;7;11
3537305;Consultório Isolado;0;0;0;217;217
3537305;Diagnose e Terapia;0;0;1;16;17
3537305;Hospital;0;0;1;4;5
3537305;Outros;0;0;4;10;14
3537305;Pronto Atendimento;0;0;1;1;2
3537305;Unidade Básica de Saúde;0;0;11;0;11
3537305;Unidade de Saúde Mental ;0;0;2;0;2
3537305;Unidade Móvel;0;0;0;0;0
3537305;Vigilância em Saúde;0;0;2;0;2
3537404;Clínica;0;0;1;7;8
3537404;Consultório Isolado;0;0;2;49;51
3537404;Diagnose e Terapia;0;0;2;4;6
3537404;Hospital;0;0;0;1;1
3537404;Outros;0;0;5;0;5
3537404;Pronto Atendimento;0;0;0;0;0
3537404;Unidade Básica de Saúde;0;0;8;0;8
3537404;Unidade de Saúde Mental ;0;0;1;0;1
3537404;Unidade Móvel;0;0;0;0;0
3537404;Vigilância em Saúde;0;0;2;0;2
3537503;Clínica;0;0;1;0;1
3537503;Consultório Isolado;0;0;0;5;5
3537503;Diagnose e Terapia;0;0;0;1;1
3537503;Hospital;0;0;0;0;0
3537503;Outros;0;0;3;0;3
3537503;Pronto Atendimento;0;0;0;0;0
3537503;Unidade Básica de Saúde;0;0;3;0;3
3537503;Unidade de Saúde Mental ;0;0;0;0;0
3537503;Unidade Móvel;0;0;0;0;0
3537503;Vigilância em Saúde;0;0;0;0;0
3537602;Clínica;0;0;5;18;23
3537602;Consultório Isolado;0;0;1;25;26
3537602;Diagnose e Terapia;0;0;0;7;7
3537602;Hospital;0;0;2;0;2
3537602;Outros;0;0;4;1;5
3537602;Pronto Atendimento;0;0;1;0;1
3537602;Unidade Básica de Saúde;0;0;16;0;16
3537602;Unidade de Saúde Mental ;0;0;1;0;1
3537602;Unidade Móvel;0;0;4;0;4
3537602;Vigilância em Saúde;0;0;2;0;2
3537701;Clínica;0;0;0;0;0
3537701;Consultório Isolado;0;0;0;1;1
3537701;Diagnose e Terapia;0;0;0;0;0
3537701;Hospital;0;0;0;0;0
3537701;Outros;0;0;2;0;2
3537701;Pronto Atendimento;0;0;0;0;0
3537701;Unidade Básica de Saúde;0;0;1;0;1
3537701;Unidade de Saúde Mental ;0;0;0;0;0
3537701;Unidade Móvel;0;0;0;0;0
3537701;Vigilância em Saúde;0;0;1;0;1
3537800;Clínica;0;0;2;13;15
3537800;Consultório Isolado;0;0;4;37;41
3537800;Diagnose e Terapia;0;0;0;4;4
3537800;Hospital;0;0;0;2;2
3537800;Outros;0;0;2;0;2
3537800;Pronto Atendimento;0;0;0;0;0
3537800;Unidade Básica de Saúde;0;0;9;0;9
3537800;Unidade de Saúde Mental ;0;0;1;0;1
3537800;Unidade Móvel;0;0;1;0;1
3537800;Vigilância em Saúde;0;0;0;0;0
3537909;Clínica;0;0;1;2;3
3537909;Consultório Isolado;0;0;0;11;11
3537909;Diagnose e Terapia;0;0;0;7;7
3537909;Hospital;0;0;0;1;1
3537909;Outros;0;0;2;1;3
3537909;Pronto Atendimento;0;0;0;0;0
3537909;Unidade Básica de Saúde;0;0;9;0;9
3537909;Unidade de Saúde Mental ;0;0;1;0;1
3537909;Unidade Móvel;0;0;1;0;1
3537909;Vigilância em Saúde;0;0;1;0;1
3538006;Clínica;0;0;6;38;44
3538006;Consultório Isolado;0;0;0;375;375
3538006;Diagnose e Terapia;0;0;1;16;17
3538006;Hospital;0;0;0;4;4
3538006;Outros;0;0;5;1;6
3538006;Pronto Atendimento;0;0;5;0;5
3538006;Unidade Básica de Saúde;0;0;28;0;28
3538006;Unidade de Saúde Mental ;0;0;3;0;3
3538006;Unidade Móvel;0;0;4;0;4
3538006;Vigilância em Saúde;0;0;1;0;1
3538105;Clínica;0;0;1;1;2
3538105;Consultório Isolado;0;0;0;11;11
3538105;Diagnose e Terapia;0;0;2;4;6
3538105;Hospital;0;0;0;0;0
3538105;Outros;0;0;3;0;3
3538105;Pronto Atendimento;0;0;0;0;0
3538105;Unidade Básica de Saúde;0;0;4;1;5
3538105;Unidade de Saúde Mental ;0;0;0;0;0
3538105;Unidade Móvel;0;0;0;0;0
3538105;Vigilância em Saúde;0;0;1;0;1
3538204;Clínica;0;0;0;4;4
3538204;Consultório Isolado;0;0;0;7;7
3538204;Diagnose e Terapia;0;0;0;1;1
3538204;Hospital;0;0;0;0;0
3538204;Outros;0;0;1;1;2
3538204;Pronto Atendimento;0;0;1;0;1
3538204;Unidade Básica de Saúde;0;0;4;0;4
3538204;Unidade de Saúde Mental ;0;0;0;0;0
3538204;Unidade Móvel;0;0;1;0;1
3538204;Vigilância em Saúde;0;0;0;0;0
3538303;Clínica;0;0;0;0;0
3538303;Consultório Isolado;0;0;0;0;0
3538303;Diagnose e Terapia;0;0;0;0;0
3538303;Hospital;0;0;0;0;0
3538303;Outros;0;0;1;0;1
3538303;Pronto Atendimento;0;0;0;0;0
3538303;Unidade Básica de Saúde;0;0;2;0;2
3538303;Unidade de Saúde Mental ;0;0;0;0;0
3538303;Unidade Móvel;0;0;0;0;0
3538303;Vigilância em Saúde;0;0;0;0;0
3538501;Clínica;0;0;1;1;2
3538501;Consultório Isolado;0;0;0;7;7
3538501;Diagnose e Terapia;0;0;0;1;1
3538501;Hospital;0;0;0;0;0
3538501;Outros;0;0;2;0;2
3538501;Pronto Atendimento;0;0;1;0;1
3538501;Unidade Básica de Saúde;0;0;5;0;5
3538501;Unidade de Saúde Mental ;0;0;0;0;0
3538501;Unidade Móvel;0;0;1;0;1
3538501;Vigilância em Saúde;0;0;0;0;0
3538600;Clínica;0;0;0;10;10
3538600;Consultório Isolado;0;0;0;10;10
3538600;Diagnose e Terapia;0;0;1;2;3
3538600;Hospital;0;0;0;1;1
3538600;Outros;0;0;1;0;1
3538600;Pronto Atendimento;0;0;0;0;0
3538600;Unidade Básica de Saúde;0;0;3;0;3
3538600;Unidade de Saúde Mental ;0;0;1;0;1
3538600;Unidade Móvel;0;0;1;0;1
3538600;Vigilância em Saúde;0;0;0;0;0
3538709;Clínica;2;0;17;413;432
3538709;Consultório Isolado;1;0;0;579;580
3538709;Diagnose e Terapia;2;0;4;83;89
3538709;Hospital;2;0;0;8;10
3538709;Outros;4;0;4;6;14
3538709;Pronto Atendimento;0;0;6;0;6
3538709;Unidade Básica de Saúde;3;0;79;0;82
3538709;Unidade de Saúde Mental ;0;0;2;0;2
3538709;Unidade Móvel;0;0;18;0;18
3538709;Vigilância em Saúde;0;0;1;0;1
3538808;Clínica;0;0;2;14;16
3538808;Consultório Isolado;0;0;0;76;76
3538808;Diagnose e Terapia;0;0;1;8;9
3538808;Hospital;0;0;0;1;1
3538808;Outros;0;0;2;1;3
3538808;Pronto Atendimento;0;0;0;0;0
3538808;Unidade Básica de Saúde;0;0;9;0;9
3538808;Unidade de Saúde Mental ;0;0;1;0;1
3538808;Unidade Móvel;0;0;0;0;0
3538808;Vigilância em Saúde;0;0;1;0;1
3538907;Clínica;0;0;0;4;4
3538907;Consultório Isolado;0;0;0;40;40
3538907;Diagnose e Terapia;0;0;1;3;4
3538907;Hospital;0;0;0;2;2
3538907;Outros;0;0;1;0;1
3538907;Pronto Atendimento;0;0;1;0;1
3538907;Unidade Básica de Saúde;3;0;6;0;9
3538907;Unidade de Saúde Mental ;0;0;1;0;1
3538907;Unidade Móvel;0;0;2;0;2
3538907;Vigilância em Saúde;0;0;0;0;0
3539004;Clínica;0;0;2;1;3
3539004;Consultório Isolado;0;0;0;18;18
3539004;Diagnose e Terapia;0;0;0;2;2
3539004;Hospital;0;0;0;1;1
3539004;Outros;0;0;1;0;1
3539004;Pronto Atendimento;0;0;1;0;1
3539004;Unidade Básica de Saúde;0;0;3;0;3
3539004;Unidade de Saúde Mental ;0;0;1;0;1
3539004;Unidade Móvel;0;0;0;0;0
3539004;Vigilância em Saúde;0;0;0;0;0
3539103;Clínica;0;0;1;1;2
3539103;Consultório Isolado;0;0;0;3;3
3539103;Diagnose e Terapia;0;0;0;0;0
3539103;Hospital;0;0;0;0;0
3539103;Outros;0;0;1;0;1
3539103;Pronto Atendimento;0;0;1;0;1
3539103;Unidade Básica de Saúde;0;0;4;0;4
3539103;Unidade de Saúde Mental ;0;0;0;0;0
3539103;Unidade Móvel;0;0;1;1;2
3539103;Vigilância em Saúde;0;0;1;0;1
3539202;Clínica;0;0;1;6;7
3539202;Consultório Isolado;0;0;1;14;15
3539202;Diagnose e Terapia;0;0;0;5;5
3539202;Hospital;0;0;0;1;1
3539202;Outros;0;0;2;0;2
3539202;Pronto Atendimento;0;0;1;0;1
3539202;Unidade Básica de Saúde;0;0;9;0;9
3539202;Unidade de Saúde Mental ;0;0;1;0;1
3539202;Unidade Móvel;0;0;0;0;0
3539202;Vigilância em Saúde;0;0;1;0;1
3539301;Clínica;0;0;5;15;20
3539301;Consultório Isolado;0;0;0;264;264
3539301;Diagnose e Terapia;2;0;1;9;12
3539301;Hospital;0;1;1;2;4
3539301;Outros;0;0;3;1;4
3539301;Pronto Atendimento;0;0;1;1;2
3539301;Unidade Básica de Saúde;0;0;20;0;20
3539301;Unidade de Saúde Mental ;0;0;3;0;3
3539301;Unidade Móvel;0;0;2;1;3
3539301;Vigilância em Saúde;0;0;2;0;2
3539400;Clínica;0;0;0;1;1
3539400;Consultório Isolado;0;0;0;0;0
3539400;Diagnose e Terapia;0;0;0;3;3
3539400;Hospital;0;0;0;1;1
3539400;Outros;0;0;2;0;2
3539400;Pronto Atendimento;0;0;1;0;1
3539400;Unidade Básica de Saúde;0;0;4;0;4
3539400;Unidade de Saúde Mental ;0;0;0;0;0
3539400;Unidade Móvel;0;0;1;0;1
3539400;Vigilância em Saúde;0;0;2;0;2
3539509;Clínica;0;0;4;15;19
3539509;Consultório Isolado;0;0;0;58;58
3539509;Diagnose e Terapia;0;0;0;7;7
3539509;Hospital;0;0;0;1;1
3539509;Outros;0;0;4;1;5
3539509;Pronto Atendimento;0;0;3;0;3
3539509;Unidade Básica de Saúde;0;0;9;0;9
3539509;Unidade de Saúde Mental ;0;0;1;0;1
3539509;Unidade Móvel;0;0;2;0;2
3539509;Vigilância em Saúde;0;0;0;0;0
3539608;Clínica;0;0;0;0;0
3539608;Consultório Isolado;0;0;0;0;0
3539608;Diagnose e Terapia;0;0;0;0;0
3539608;Hospital;0;0;0;0;0
3539608;Outros;0;0;1;0;1
3539608;Pronto Atendimento;0;0;0;0;0
3539608;Unidade Básica de Saúde;0;0;1;0;1
3539608;Unidade de Saúde Mental ;0;0;0;0;0
3539608;Unidade Móvel;0;0;1;0;1
3539608;Vigilância em Saúde;0;0;0;0;0
3539707;Clínica;0;0;0;0;0
3539707;Consultório Isolado;0;0;0;0;0
3539707;Diagnose e Terapia;0;0;0;0;0
3539707;Hospital;0;0;0;0;0
3539707;Outros;0;0;1;0;1
3539707;Pronto Atendimento;0;0;0;0;0
3539707;Unidade Básica de Saúde;0;0;1;0;1
3539707;Unidade de Saúde Mental ;0;0;0;0;0
3539707;Unidade Móvel;0;0;0;0;0
3539707;Vigilância em Saúde;0;0;0;0;0
3539806;Clínica;0;0;5;13;18
3539806;Consultório Isolado;0;0;0;26;26
3539806;Diagnose e Terapia;0;0;0;9;9
3539806;Hospital;0;0;1;0;1
3539806;Outros;0;0;4;0;4
3539806;Pronto Atendimento;0;0;1;0;1
3539806;Unidade Básica de Saúde;0;0;16;0;16
3539806;Unidade de Saúde Mental ;0;0;2;0;2
3539806;Unidade Móvel;0;0;1;0;1
3539806;Vigilância em Saúde;0;0;2;0;2
3539905;Clínica;0;0;1;0;1
3539905;Consultório Isolado;0;0;1;9;10
3539905;Diagnose e Terapia;0;0;0;3;3
3539905;Hospital;0;0;0;0;0
3539905;Outros;0;0;1;0;1
3539905;Pronto Atendimento;0;0;0;0;0
3539905;Unidade Básica de Saúde;0;0;1;0;1
3539905;Unidade de Saúde Mental ;0;0;0;0;0
3539905;Unidade Móvel;0;0;0;0;0
3539905;Vigilância em Saúde;0;0;0;0;0
3540002;Clínica;0;0;5;6;11
3540002;Consultório Isolado;0;0;0;141;141
3540002;Diagnose e Terapia;0;0;0;5;5
3540002;Hospital;0;0;0;1;1
3540002;Outros;0;0;4;0;4
3540002;Pronto Atendimento;0;0;0;1;1
3540002;Unidade Básica de Saúde;0;0;11;0;11
3540002;Unidade de Saúde Mental ;0;0;1;0;1
3540002;Unidade Móvel;0;0;1;0;1
3540002;Vigilância em Saúde;0;0;1;0;1
3540101;Clínica;0;0;0;0;0
3540101;Consultório Isolado;0;0;0;1;1
3540101;Diagnose e Terapia;0;0;0;0;0
3540101;Hospital;0;0;0;0;0
3540101;Outros;0;0;1;0;1
3540101;Pronto Atendimento;0;0;0;0;0
3540101;Unidade Básica de Saúde;0;0;1;0;1
3540101;Unidade de Saúde Mental ;0;0;0;0;0
3540101;Unidade Móvel;0;0;0;0;0
3540101;Vigilância em Saúde;0;0;0;0;0
3540200;Clínica;0;0;2;5;7
3540200;Consultório Isolado;0;0;0;47;47
3540200;Diagnose e Terapia;0;0;0;17;17
3540200;Hospital;0;0;0;1;1
3540200;Outros;0;0;2;1;3
3540200;Pronto Atendimento;0;0;1;0;1
3540200;Unidade Básica de Saúde;1;0;13;1;15
3540200;Unidade de Saúde Mental ;0;0;1;0;1
3540200;Unidade Móvel;0;0;1;0;1
3540200;Vigilância em Saúde;0;0;3;0;3
3540259;Clínica;0;0;0;0;0
3540259;Consultório Isolado;0;0;0;1;1
3540259;Diagnose e Terapia;0;0;0;0;0
3540259;Hospital;0;0;0;0;0
3540259;Outros;0;0;1;0;1
3540259;Pronto Atendimento;0;0;0;0;0
3540259;Unidade Básica de Saúde;0;0;1;0;1
3540259;Unidade de Saúde Mental ;0;0;0;0;0
3540259;Unidade Móvel;0;0;0;0;0
3540259;Vigilância em Saúde;0;0;0;0;0
3540309;Clínica;0;0;0;0;0
3540309;Consultório Isolado;0;0;0;1;1
3540309;Diagnose e Terapia;0;0;0;0;0
3540309;Hospital;0;0;0;0;0
3540309;Outros;0;0;1;0;1
3540309;Pronto Atendimento;0;0;0;0;0
3540309;Unidade Básica de Saúde;0;0;2;0;2
3540309;Unidade de Saúde Mental ;0;0;0;0;0
3540309;Unidade Móvel;0;0;0;0;0
3540309;Vigilância em Saúde;0;0;0;0;0
3540408;Clínica;0;0;0;0;0
3540408;Consultório Isolado;0;0;0;1;1
3540408;Diagnose e Terapia;0;0;0;1;1
3540408;Hospital;0;0;0;1;1
3540408;Outros;0;0;1;0;1
3540408;Pronto Atendimento;0;0;0;0;0
3540408;Unidade Básica de Saúde;0;0;1;0;1
3540408;Unidade de Saúde Mental ;0;0;0;0;0
3540408;Unidade Móvel;0;0;0;0;0
3540408;Vigilância em Saúde;0;0;0;0;0
3540507;Clínica;0;0;0;1;1
3540507;Consultório Isolado;0;0;0;8;8
3540507;Diagnose e Terapia;0;0;0;1;1
3540507;Hospital;0;0;0;0;0
3540507;Outros;0;0;2;0;2
3540507;Pronto Atendimento;0;0;0;0;0
3540507;Unidade Básica de Saúde;0;0;4;0;4
3540507;Unidade de Saúde Mental ;0;0;0;0;0
3540507;Unidade Móvel;0;0;0;0;0
3540507;Vigilância em Saúde;0;0;2;0;2
3540606;Clínica;0;0;3;10;13
3540606;Consultório Isolado;0;0;0;70;70
3540606;Diagnose e Terapia;0;0;0;8;8
3540606;Hospital;0;0;0;1;1
3540606;Outros;0;0;7;0;7
3540606;Pronto Atendimento;0;0;0;0;0
3540606;Unidade Básica de Saúde;1;0;11;0;12
3540606;Unidade de Saúde Mental ;0;0;1;0;1
3540606;Unidade Móvel;0;0;0;0;0
3540606;Vigilância em Saúde;0;0;2;0;2
3540705;Clínica;0;0;4;12;16
3540705;Consultório Isolado;0;0;0;167;167
3540705;Diagnose e Terapia;0;0;0;25;25
3540705;Hospital;0;0;0;1;1
3540705;Outros;0;0;3;0;3
3540705;Pronto Atendimento;0;0;1;1;2
3540705;Unidade Básica de Saúde;0;0;12;0;12
3540705;Unidade de Saúde Mental ;0;0;1;0;1
3540705;Unidade Móvel;0;0;0;0;0
3540705;Vigilância em Saúde;0;0;2;0;2
3540754;Clínica;0;0;1;0;1
3540754;Consultório Isolado;0;0;0;0;0
3540754;Diagnose e Terapia;0;0;0;3;3
3540754;Hospital;0;0;0;0;0
3540754;Outros;0;0;7;0;7
3540754;Pronto Atendimento;0;0;0;0;0
3540754;Unidade Básica de Saúde;2;0;7;0;9
3540754;Unidade de Saúde Mental ;0;0;1;0;1
3540754;Unidade Móvel;0;0;1;0;1
3540754;Vigilância em Saúde;0;0;0;0;0
3540804;Clínica;0;0;2;2;4
3540804;Consultório Isolado;0;0;0;16;16
3540804;Diagnose e Terapia;0;0;0;3;3
3540804;Hospital;0;0;0;1;1
3540804;Outros;0;0;1;0;1
3540804;Pronto Atendimento;0;0;0;0;0
3540804;Unidade Básica de Saúde;0;0;5;0;5
3540804;Unidade de Saúde Mental ;0;0;0;0;0
3540804;Unidade Móvel;0;0;0;0;0
3540804;Vigilância em Saúde;0;0;0;0;0
3540853;Clínica;0;0;0;0;0
3540853;Consultório Isolado;0;0;0;0;0
3540853;Diagnose e Terapia;0;0;0;0;0
3540853;Hospital;0;0;0;0;0
3540853;Outros;0;0;1;0;1
3540853;Pronto Atendimento;0;0;0;0;0
3540853;Unidade Básica de Saúde;1;0;1;0;2
3540853;Unidade de Saúde Mental ;0;0;0;0;0
3540853;Unidade Móvel;0;0;0;0;0
3540853;Vigilância em Saúde;0;0;0;0;0
3540903;Clínica;0;0;1;0;1
3540903;Consultório Isolado;0;0;1;16;17
3540903;Diagnose e Terapia;0;0;0;2;2
3540903;Hospital;0;0;0;0;0
3540903;Outros;0;0;2;0;2
3540903;Pronto Atendimento;0;0;1;1;2
3540903;Unidade Básica de Saúde;0;0;3;0;3
3540903;Unidade de Saúde Mental ;0;0;0;0;0
3540903;Unidade Móvel;0;0;1;0;1
3540903;Vigilância em Saúde;0;0;1;0;1
3541000;Clínica;1;0;9;63;73
3541000;Consultório Isolado;0;0;0;151;151
3541000;Diagnose e Terapia;0;0;1;33;34
3541000;Hospital;0;0;5;3;8
3541000;Outros;0;0;5;4;9
3541000;Pronto Atendimento;0;0;4;4;8
3541000;Unidade Básica de Saúde;1;0;30;0;31
3541000;Unidade de Saúde Mental ;0;0;4;0;4
3541000;Unidade Móvel;0;0;11;0;11
3541000;Vigilância em Saúde;0;0;3;0;3
3541059;Clínica;0;0;1;0;1
3541059;Consultório Isolado;0;0;0;3;3
3541059;Diagnose e Terapia;0;0;0;0;0
3541059;Hospital;0;0;0;0;0
3541059;Outros;0;0;1;0;1
3541059;Pronto Atendimento;0;0;0;0;0
3541059;Unidade Básica de Saúde;0;0;2;0;2
3541059;Unidade de Saúde Mental ;0;0;0;0;0
3541059;Unidade Móvel;0;0;0;0;0
3541059;Vigilância em Saúde;0;0;1;0;1
3541109;Clínica;0;0;0;1;1
3541109;Consultório Isolado;0;0;0;0;0
3541109;Diagnose e Terapia;0;0;0;0;0
3541109;Hospital;0;0;0;1;1
3541109;Outros;0;0;2;0;2
3541109;Pronto Atendimento;0;0;0;0;0
3541109;Unidade Básica de Saúde;0;0;2;0;2
3541109;Unidade de Saúde Mental ;0;0;0;0;0
3541109;Unidade Móvel;0;0;0;0;0
3541109;Vigilância em Saúde;0;0;0;0;0
3541208;Clínica;0;0;0;2;2
3541208;Consultório Isolado;0;0;0;20;20
3541208;Diagnose e Terapia;0;0;0;2;2
3541208;Hospital;0;0;0;1;1
3541208;Outros;0;0;1;0;1
3541208;Pronto Atendimento;0;0;0;0;0
3541208;Unidade Básica de Saúde;3;0;7;0;10
3541208;Unidade de Saúde Mental ;0;0;1;0;1
3541208;Unidade Móvel;0;0;0;0;0
3541208;Vigilância em Saúde;0;0;2;0;2
3541307;Clínica;0;0;0;3;3
3541307;Consultório Isolado;0;0;1;40;41
3541307;Diagnose e Terapia;0;0;1;8;9
3541307;Hospital;0;0;0;1;1
3541307;Outros;0;0;2;0;2
3541307;Pronto Atendimento;0;0;0;0;0
3541307;Unidade Básica de Saúde;0;0;11;1;12
3541307;Unidade de Saúde Mental ;0;0;1;0;1
3541307;Unidade Móvel;0;0;1;0;1
3541307;Vigilância em Saúde;0;0;1;0;1
3541406;Clínica;3;0;9;83;95
3541406;Consultório Isolado;0;0;0;818;818
3541406;Diagnose e Terapia;2;0;1;45;48
3541406;Hospital;2;0;0;16;18
3541406;Outros;2;0;6;13;21
3541406;Pronto Atendimento;0;0;6;0;6
3541406;Unidade Básica de Saúde;2;0;32;1;35
3541406;Unidade de Saúde Mental ;0;0;4;0;4
3541406;Unidade Móvel;0;0;9;1;10
3541406;Vigilância em Saúde;0;0;2;0;2
3541505;Clínica;0;0;1;4;5
3541505;Consultório Isolado;0;0;3;82;85
3541505;Diagnose e Terapia;0;0;0;9;9
3541505;Hospital;0;0;0;1;1
3541505;Outros;1;0;2;0;3
3541505;Pronto Atendimento;0;0;0;0;0
3541505;Unidade Básica de Saúde;2;0;10;0;12
3541505;Unidade de Saúde Mental ;0;0;1;0;1
3541505;Unidade Móvel;0;0;0;1;1
3541505;Vigilância em Saúde;0;0;1;0;1
3541604;Clínica;1;0;2;2;5
3541604;Consultório Isolado;0;0;0;70;70
3541604;Diagnose e Terapia;0;0;0;10;10
3541604;Hospital;1;0;0;0;1
3541604;Outros;0;0;1;0;1
3541604;Pronto Atendimento;0;0;0;0;0
3541604;Unidade Básica de Saúde;0;0;16;0;16
3541604;Unidade de Saúde Mental ;0;0;1;0;1
3541604;Unidade Móvel;0;0;0;0;0
3541604;Vigilância em Saúde;0;0;0;0;0
3541653;Clínica;0;0;0;0;0
3541653;Consultório Isolado;0;0;0;2;2
3541653;Diagnose e Terapia;0;0;0;0;0
3541653;Hospital;0;0;0;0;0
3541653;Outros;0;0;2;0;2
3541653;Pronto Atendimento;0;0;0;0;0
3541653;Unidade Básica de Saúde;0;0;1;0;1
3541653;Unidade de Saúde Mental ;0;0;0;0;0
3541653;Unidade Móvel;0;0;1;0;1
3541653;Vigilância em Saúde;0;0;0;0;0
3541703;Clínica;0;0;0;1;1
3541703;Consultório Isolado;0;0;0;24;24
3541703;Diagnose e Terapia;0;0;1;2;3
3541703;Hospital;0;0;0;0;0
3541703;Outros;0;0;3;0;3
3541703;Pronto Atendimento;0;0;1;1;2
3541703;Unidade Básica de Saúde;0;0;6;0;6
3541703;Unidade de Saúde Mental ;0;0;1;0;1
3541703;Unidade Móvel;0;0;0;0;0
3541703;Vigilância em Saúde;0;0;0;0;0
3541802;Clínica;0;0;0;0;0
3541802;Consultório Isolado;0;0;0;0;0
3541802;Diagnose e Terapia;0;0;0;0;0
3541802;Hospital;0;0;0;0;0
3541802;Outros;0;0;1;0;1
3541802;Pronto Atendimento;0;0;0;0;0
3541802;Unidade Básica de Saúde;0;0;1;0;1
3541802;Unidade de Saúde Mental ;0;0;0;0;0
3541802;Unidade Móvel;0;0;0;0;0
3541802;Vigilância em Saúde;0;0;0;0;0
3541901;Clínica;0;0;1;0;1
3541901;Consultório Isolado;0;0;0;0;0
3541901;Diagnose e Terapia;0;0;0;0;0
3541901;Hospital;0;0;1;1;2
3541901;Outros;0;0;4;0;4
3541901;Pronto Atendimento;0;0;1;0;1
3541901;Unidade Básica de Saúde;0;0;4;0;4
3541901;Unidade de Saúde Mental ;0;0;0;0;0
3541901;Unidade Móvel;0;0;1;0;1
3541901;Vigilância em Saúde;0;0;0;0;0
3542008;Clínica;0;0;2;1;3
3542008;Consultório Isolado;0;0;0;17;17
3542008;Diagnose e Terapia;0;0;0;1;1
3542008;Hospital;0;0;0;0;0
3542008;Outros;0;0;3;0;3
3542008;Pronto Atendimento;0;0;0;1;1
3542008;Unidade Básica de Saúde;0;0;5;0;5
3542008;Unidade de Saúde Mental ;0;0;0;0;0
3542008;Unidade Móvel;0;0;0;0;0
3542008;Vigilância em Saúde;0;0;1;0;1
3542107;Clínica;0;0;0;1;1
3542107;Consultório Isolado;0;0;2;2;4
3542107;Diagnose e Terapia;0;0;0;0;0
3542107;Hospital;0;0;0;0;0
3542107;Outros;0;0;1;0;1
3542107;Pronto Atendimento;0;0;0;0;0
3542107;Unidade Básica de Saúde;0;0;3;0;3
3542107;Unidade de Saúde Mental ;0;0;0;0;0
3542107;Unidade Móvel;0;0;0;0;0
3542107;Vigilância em Saúde;0;0;0;0;0
3542206;Clínica;0;0;0;6;6
3542206;Consultório Isolado;0;0;0;58;58
3542206;Diagnose e Terapia;0;0;0;10;10
3542206;Hospital;0;0;0;1;1
3542206;Outros;0;0;2;0;2
3542206;Pronto Atendimento;0;0;0;0;0
3542206;Unidade Básica de Saúde;0;0;10;0;10
3542206;Unidade de Saúde Mental ;0;0;2;0;2
3542206;Unidade Móvel;0;0;0;0;0
3542206;Vigilância em Saúde;0;0;0;0;0
3542305;Clínica;0;0;0;0;0
3542305;Consultório Isolado;0;0;0;1;1
3542305;Diagnose e Terapia;0;0;0;0;0
3542305;Hospital;0;0;0;0;0
3542305;Outros;0;0;1;0;1
3542305;Pronto Atendimento;0;0;0;0;0
3542305;Unidade Básica de Saúde;0;0;2;0;2
3542305;Unidade de Saúde Mental ;0;0;0;0;0
3542305;Unidade Móvel;0;0;1;0;1
3542305;Vigilância em Saúde;0;0;0;0;0
3542404;Clínica;0;0;0;1;1
3542404;Consultório Isolado;0;0;1;27;28
3542404;Diagnose e Terapia;0;0;0;5;5
3542404;Hospital;0;0;0;1;1
3542404;Outros;0;0;1;0;1
3542404;Pronto Atendimento;0;0;0;0;0
3542404;Unidade Básica de Saúde;0;0;11;0;11
3542404;Unidade de Saúde Mental ;0;0;0;0;0
3542404;Unidade Móvel;0;0;0;0;0
3542404;Vigilância em Saúde;0;0;1;0;1
3542503;Clínica;0;0;0;1;1
3542503;Consultório Isolado;0;0;0;4;4
3542503;Diagnose e Terapia;0;0;0;0;0
3542503;Hospital;0;0;0;0;0
3542503;Outros;0;0;1;0;1
3542503;Pronto Atendimento;0;0;0;0;0
3542503;Unidade Básica de Saúde;2;0;2;0;4
3542503;Unidade de Saúde Mental ;0;0;0;0;0
3542503;Unidade Móvel;0;0;0;0;0
3542503;Vigilância em Saúde;0;0;0;0;0
3542602;Clínica;0;0;6;20;26
3542602;Consultório Isolado;0;0;1;62;63
3542602;Diagnose e Terapia;0;0;1;11;12
3542602;Hospital;1;0;0;2;3
3542602;Outros;3;1;6;4;14
3542602;Pronto Atendimento;0;0;2;0;2
3542602;Unidade Básica de Saúde;1;0;17;0;18
3542602;Unidade de Saúde Mental ;0;0;2;0;2
3542602;Unidade Móvel;0;0;0;0;0
3542602;Vigilância em Saúde;0;0;1;0;1
3542701;Clínica;0;0;1;0;1
3542701;Consultório Isolado;0;0;0;0;0
3542701;Diagnose e Terapia;0;0;0;0;0
3542701;Hospital;0;0;0;0;0
3542701;Outros;0;0;1;0;1
3542701;Pronto Atendimento;0;0;0;0;0
3542701;Unidade Básica de Saúde;0;0;2;0;2
3542701;Unidade de Saúde Mental ;0;0;0;0;0
3542701;Unidade Móvel;0;0;0;0;0
3542701;Vigilância em Saúde;0;0;0;0;0
3542800;Clínica;0;0;0;0;0
3542800;Consultório Isolado;0;0;0;0;0
3542800;Diagnose e Terapia;0;0;0;0;0
3542800;Hospital;0;0;0;0;0
3542800;Outros;0;0;2;0;2
3542800;Pronto Atendimento;0;0;0;0;0
3542800;Unidade Básica de Saúde;0;0;3;0;3
3542800;Unidade de Saúde Mental ;0;0;0;0;0
3542800;Unidade Móvel;0;0;1;0;1
3542800;Vigilância em Saúde;0;0;1;0;1
3542909;Clínica;0;0;1;2;3
3542909;Consultório Isolado;0;0;0;25;25
3542909;Diagnose e Terapia;0;0;0;0;0
3542909;Hospital;0;0;0;1;1
3542909;Outros;0;0;1;0;1
3542909;Pronto Atendimento;0;0;1;0;1
3542909;Unidade Básica de Saúde;0;0;4;0;4
3542909;Unidade de Saúde Mental ;0;0;0;0;0
3542909;Unidade Móvel;0;0;0;0;0
3542909;Vigilância em Saúde;0;0;0;0;0
3543006;Clínica;0;0;0;2;2
3543006;Consultório Isolado;0;0;0;0;0
3543006;Diagnose e Terapia;0;0;0;1;1
3543006;Hospital;0;0;1;0;1
3543006;Outros;0;0;4;1;5
3543006;Pronto Atendimento;0;0;0;0;0
3543006;Unidade Básica de Saúde;0;0;8;0;8
3543006;Unidade de Saúde Mental ;0;0;0;0;0
3543006;Unidade Móvel;0;0;0;0;0
3543006;Vigilância em Saúde;0;0;1;0;1
3543105;Clínica;0;0;1;0;1
3543105;Consultório Isolado;0;0;1;0;1
3543105;Diagnose e Terapia;0;0;0;1;1
3543105;Hospital;0;0;0;0;0
3543105;Outros;0;0;1;0;1
3543105;Pronto Atendimento;0;0;0;0;0
3543105;Unidade Básica de Saúde;0;0;2;0;2
3543105;Unidade de Saúde Mental ;0;0;0;0;0
3543105;Unidade Móvel;0;0;0;0;0
3543105;Vigilância em Saúde;0;0;0;0;0
3543204;Clínica;0;0;1;0;1
3543204;Consultório Isolado;0;0;0;0;0
3543204;Diagnose e Terapia;0;0;0;0;0
3543204;Hospital;0;0;0;0;0
3543204;Outros;0;0;1;0;1
3543204;Pronto Atendimento;0;0;0;0;0
3543204;Unidade Básica de Saúde;0;0;1;0;1
3543204;Unidade de Saúde Mental ;0;0;0;0;0
3543204;Unidade Móvel;0;0;0;0;0
3543204;Vigilância em Saúde;0;0;0;0;0
3543238;Clínica;0;0;0;0;0
3543238;Consultório Isolado;0;0;0;0;0
3543238;Diagnose e Terapia;0;0;0;0;0
3543238;Hospital;0;0;0;0;0
3543238;Outros;0;0;1;0;1
3543238;Pronto Atendimento;0;0;0;0;0
3543238;Unidade Básica de Saúde;0;0;1;0;1
3543238;Unidade de Saúde Mental ;0;0;0;0;0
3543238;Unidade Móvel;0;0;0;0;0
3543238;Vigilância em Saúde;0;0;0;0;0
3543253;Clínica;0;0;0;0;0
3543253;Consultório Isolado;0;0;0;2;2
3543253;Diagnose e Terapia;0;0;0;0;0
3543253;Hospital;0;0;0;0;0
3543253;Outros;0;0;2;0;2
3543253;Pronto Atendimento;0;0;0;0;0
3543253;Unidade Básica de Saúde;0;0;1;0;1
3543253;Unidade de Saúde Mental ;0;0;0;0;0
3543253;Unidade Móvel;0;0;0;0;0
3543253;Vigilância em Saúde;0;0;1;0;1
3543303;Clínica;0;0;2;27;29
3543303;Consultório Isolado;0;0;0;66;66
3543303;Diagnose e Terapia;0;0;0;11;11
3543303;Hospital;0;0;2;1;3
3543303;Outros;0;0;3;1;4
3543303;Pronto Atendimento;0;0;1;0;1
3543303;Unidade Básica de Saúde;0;0;13;0;13
3543303;Unidade de Saúde Mental ;0;0;3;0;3
3543303;Unidade Móvel;0;0;0;0;0
3543303;Vigilância em Saúde;0;0;1;0;1
3543402;Clínica;3;0;13;700;716
3543402;Consultório Isolado;0;0;50;2013;2063
3543402;Diagnose e Terapia;2;0;2;149;153
3543402;Hospital;3;0;1;21;25
3543402;Outros;6;0;2;40;48
3543402;Pronto Atendimento;0;0;4;2;6
3543402;Unidade Básica de Saúde;3;0;50;1;54
3543402;Unidade de Saúde Mental ;0;0;5;1;6
3543402;Unidade Móvel;0;0;17;10;27
3543402;Vigilância em Saúde;1;0;3;0;4
3543501;Clínica;0;0;0;1;1
3543501;Consultório Isolado;0;0;0;0;0
3543501;Diagnose e Terapia;0;0;0;0;0
3543501;Hospital;0;0;0;0;0
3543501;Outros;0;0;2;5;7
3543501;Pronto Atendimento;0;0;1;0;1
3543501;Unidade Básica de Saúde;0;0;2;0;2
3543501;Unidade de Saúde Mental ;0;0;0;0;0
3543501;Unidade Móvel;0;0;0;0;0
3543501;Vigilância em Saúde;0;0;1;0;1
3543600;Clínica;0;0;2;0;2
3543600;Consultório Isolado;0;0;1;1;2
3543600;Diagnose e Terapia;0;0;0;1;1
3543600;Hospital;0;0;0;0;0
3543600;Outros;0;0;1;0;1
3543600;Pronto Atendimento;0;0;0;0;0
3543600;Unidade Básica de Saúde;0;0;2;0;2
3543600;Unidade de Saúde Mental ;0;0;0;0;0
3543600;Unidade Móvel;0;0;0;0;0
3543600;Vigilância em Saúde;0;0;1;0;1
3543709;Clínica;0;0;0;3;3
3543709;Consultório Isolado;0;0;0;7;7
3543709;Diagnose e Terapia;0;0;1;1;2
3543709;Hospital;0;0;0;0;0
3543709;Outros;0;0;2;0;2
3543709;Pronto Atendimento;0;0;1;0;1
3543709;Unidade Básica de Saúde;0;0;3;0;3
3543709;Unidade de Saúde Mental ;0;0;0;0;0
3543709;Unidade Móvel;0;0;0;1;1
3543709;Vigilância em Saúde;0;0;0;0;0
3543808;Clínica;0;0;1;1;2
3543808;Consultório Isolado;0;0;0;0;0
3543808;Diagnose e Terapia;0;0;0;4;4
3543808;Hospital;0;0;0;1;1
3543808;Outros;0;0;1;0;1
3543808;Pronto Atendimento;0;0;0;0;0
3543808;Unidade Básica de Saúde;0;0;4;0;4
3543808;Unidade de Saúde Mental ;0;0;0;0;0
3543808;Unidade Móvel;0;0;0;0;0
3543808;Vigilância em Saúde;0;0;0;0;0
3543907;Clínica;1;0;7;83;91
3543907;Consultório Isolado;0;0;2;487;489
3543907;Diagnose e Terapia;1;0;1;43;45
3543907;Hospital;0;0;1;7;8
3543907;Outros;0;0;7;5;12
3543907;Pronto Atendimento;0;0;3;0;3
3543907;Unidade Básica de Saúde;3;0;21;0;24
3543907;Unidade de Saúde Mental ;0;0;3;0;3
3543907;Unidade Móvel;0;0;4;0;4
3543907;Vigilância em Saúde;0;0;2;0;2
3544004;Clínica;0;0;2;9;11
3544004;Consultório Isolado;0;0;1;69;70
3544004;Diagnose e Terapia;0;0;0;4;4
3544004;Hospital;0;0;0;1;1
3544004;Outros;0;0;1;0;1
3544004;Pronto Atendimento;0;0;1;0;1
3544004;Unidade Básica de Saúde;0;0;5;0;5
3544004;Unidade de Saúde Mental ;0;0;1;0;1
3544004;Unidade Móvel;0;0;0;0;0
3544004;Vigilância em Saúde;0;0;0;0;0
3544103;Clínica;0;0;2;2;4
3544103;Consultório Isolado;0;0;1;7;8
3544103;Diagnose e Terapia;0;0;0;1;1
3544103;Hospital;0;0;0;0;0
3544103;Outros;0;0;3;0;3
3544103;Pronto Atendimento;0;0;2;0;2
3544103;Unidade Básica de Saúde;0;0;8;0;8
3544103;Unidade de Saúde Mental ;0;0;1;0;1
3544103;Unidade Móvel;0;0;0;0;0
3544103;Vigilância em Saúde;0;0;1;0;1
3544202;Clínica;0;0;2;1;3
3544202;Consultório Isolado;0;0;0;2;2
3544202;Diagnose e Terapia;0;0;0;1;1
3544202;Hospital;0;0;0;1;1
3544202;Outros;0;0;1;0;1
3544202;Pronto Atendimento;0;0;0;0;0
3544202;Unidade Básica de Saúde;2;0;3;0;5
3544202;Unidade de Saúde Mental ;0;0;0;0;0
3544202;Unidade Móvel;0;0;0;0;0
3544202;Vigilância em Saúde;0;0;0;0;0
3544251;Clínica;0;0;0;0;0
3544251;Consultório Isolado;0;0;0;30;30
3544251;Diagnose e Terapia;0;0;0;5;5
3544251;Hospital;1;0;0;0;1
3544251;Outros;0;0;1;0;1
3544251;Pronto Atendimento;0;0;0;0;0
3544251;Unidade Básica de Saúde;0;0;10;0;10
3544251;Unidade de Saúde Mental ;0;0;0;0;0
3544251;Unidade Móvel;0;0;0;0;0
3544251;Vigilância em Saúde;0;0;1;0;1
3544301;Clínica;0;0;0;1;1
3544301;Consultório Isolado;0;0;0;3;3
3544301;Diagnose e Terapia;0;0;0;1;1
3544301;Hospital;0;0;0;1;1
3544301;Outros;0;0;2;0;2
3544301;Pronto Atendimento;0;0;0;0;0
3544301;Unidade Básica de Saúde;0;0;5;0;5
3544301;Unidade de Saúde Mental ;0;0;0;0;0
3544301;Unidade Móvel;0;0;0;1;1
3544301;Vigilância em Saúde;0;0;0;0;0
3544400;Clínica;0;0;0;0;0
3544400;Consultório Isolado;0;0;0;1;1
3544400;Diagnose e Terapia;0;0;1;0;1
3544400;Hospital;0;0;0;0;0
3544400;Outros;0;0;1;0;1
3544400;Pronto Atendimento;0;0;0;0;0
3544400;Unidade Básica de Saúde;0;0;2;0;2
3544400;Unidade de Saúde Mental ;0;0;0;0;0
3544400;Unidade Móvel;0;0;0;0;0
3544400;Vigilância em Saúde;0;0;1;0;1
3544509;Clínica;0;0;0;0;0
3544509;Consultório Isolado;0;0;0;0;0
3544509;Diagnose e Terapia;0;0;0;0;0
3544509;Hospital;0;0;0;0;0
3544509;Outros;0;0;1;0;1
3544509;Pronto Atendimento;0;0;0;0;0
3544509;Unidade Básica de Saúde;0;0;2;0;2
3544509;Unidade de Saúde Mental ;0;0;0;0;0
3544509;Unidade Móvel;0;0;0;0;0
3544509;Vigilância em Saúde;0;0;0;0;0
3544608;Clínica;0;0;0;2;2
3544608;Consultório Isolado;0;0;0;4;4
3544608;Diagnose e Terapia;0;0;0;0;0
3544608;Hospital;0;0;0;0;0
3544608;Outros;0;0;1;0;1
3544608;Pronto Atendimento;0;0;0;0;0
3544608;Unidade Básica de Saúde;0;0;2;0;2
3544608;Unidade de Saúde Mental ;0;0;0;0;0
3544608;Unidade Móvel;0;0;0;0;0
3544608;Vigilância em Saúde;0;0;0;0;0
3544707;Clínica;0;0;0;0;0
3544707;Consultório Isolado;0;0;0;0;0
3544707;Diagnose e Terapia;0;0;0;0;0
3544707;Hospital;0;0;0;0;0
3544707;Outros;0;0;1;0;1
3544707;Pronto Atendimento;0;0;0;0;0
3544707;Unidade Básica de Saúde;0;0;1;0;1
3544707;Unidade de Saúde Mental ;0;0;0;0;0
3544707;Unidade Móvel;0;0;0;0;0
3544707;Vigilância em Saúde;0;0;0;0;0
3544806;Clínica;0;0;0;0;0
3544806;Consultório Isolado;0;0;0;1;1
3544806;Diagnose e Terapia;0;0;0;1;1
3544806;Hospital;0;0;0;0;0
3544806;Outros;0;0;1;0;1
3544806;Pronto Atendimento;0;0;1;0;1
3544806;Unidade Básica de Saúde;0;0;1;0;1
3544806;Unidade de Saúde Mental ;0;0;0;0;0
3544806;Unidade Móvel;0;0;0;0;0
3544806;Vigilância em Saúde;0;0;0;0;0
3544905;Clínica;0;0;0;1;1
3544905;Consultório Isolado;0;0;0;36;36
3544905;Diagnose e Terapia;0;0;1;3;4
3544905;Hospital;0;0;0;1;1
3544905;Outros;0;0;2;1;3
3544905;Pronto Atendimento;0;0;1;0;1
3544905;Unidade Básica de Saúde;0;0;5;0;5
3544905;Unidade de Saúde Mental ;0;0;0;0;0
3544905;Unidade Móvel;0;0;0;0;0
3544905;Vigilância em Saúde;0;0;1;0;1
3545001;Clínica;0;0;1;0;1
3545001;Consultório Isolado;0;0;2;4;6
3545001;Diagnose e Terapia;0;0;1;0;1
3545001;Hospital;0;0;0;1;1
3545001;Outros;0;0;3;0;3
3545001;Pronto Atendimento;0;0;0;0;0
3545001;Unidade Básica de Saúde;0;0;2;0;2
3545001;Unidade de Saúde Mental ;0;0;0;0;0
3545001;Unidade Móvel;0;0;1;0;1
3545001;Vigilância em Saúde;0;0;2;0;2
3545100;Clínica;0;0;0;0;0
3545100;Consultório Isolado;0;0;0;0;0
3545100;Diagnose e Terapia;0;0;0;0;0
3545100;Hospital;0;0;0;0;0
3545100;Outros;0;0;1;0;1
3545100;Pronto Atendimento;0;0;0;0;0
3545100;Unidade Básica de Saúde;0;0;2;0;2
3545100;Unidade de Saúde Mental ;0;0;0;0;0
3545100;Unidade Móvel;0;0;0;0;0
3545100;Vigilância em Saúde;0;0;0;0;0
3545159;Clínica;0;0;0;0;0
3545159;Consultório Isolado;0;0;0;3;3
3545159;Diagnose e Terapia;0;0;0;2;2
3545159;Hospital;0;0;0;0;0
3545159;Outros;0;0;1;0;1
3545159;Pronto Atendimento;0;0;0;0;0
3545159;Unidade Básica de Saúde;0;0;2;0;2
3545159;Unidade de Saúde Mental ;0;0;0;0;0
3545159;Unidade Móvel;0;0;0;0;0
3545159;Vigilância em Saúde;0;0;0;0;0
3545209;Clínica;0;0;9;19;28
3545209;Consultório Isolado;0;0;1;162;163
3545209;Diagnose e Terapia;0;0;0;10;10
3545209;Hospital;0;0;2;1;3
3545209;Outros;0;0;6;4;10
3545209;Pronto Atendimento;0;0;0;0;0
3545209;Unidade Básica de Saúde;0;0;12;0;12
3545209;Unidade de Saúde Mental ;0;0;2;0;2
3545209;Unidade Móvel;0;0;0;1;1
3545209;Vigilância em Saúde;0;0;3;0;3
3545308;Clínica;0;0;1;6;7
3545308;Consultório Isolado;0;0;0;55;55
3545308;Diagnose e Terapia;0;0;1;7;8
3545308;Hospital;0;0;1;3;4
3545308;Outros;0;0;3;5;8
3545308;Pronto Atendimento;0;0;0;0;0
3545308;Unidade Básica de Saúde;0;0;11;0;11
3545308;Unidade de Saúde Mental ;0;0;3;0;3
3545308;Unidade Móvel;0;0;0;0;0
3545308;Vigilância em Saúde;0;0;3;0;3
3545407;Clínica;0;0;0;1;1
3545407;Consultório Isolado;0;0;0;2;2
3545407;Diagnose e Terapia;0;0;0;1;1
3545407;Hospital;0;0;0;1;1
3545407;Outros;0;0;1;0;1
3545407;Pronto Atendimento;0;0;0;0;0
3545407;Unidade Básica de Saúde;0;0;3;0;3
3545407;Unidade de Saúde Mental ;0;0;0;0;0
3545407;Unidade Móvel;0;0;0;0;0
3545407;Vigilância em Saúde;0;0;0;0;0
3545506;Clínica;0;0;0;0;0
3545506;Consultório Isolado;0;0;0;0;0
3545506;Diagnose e Terapia;0;0;0;1;1
3545506;Hospital;0;0;0;0;0
3545506;Outros;0;0;1;0;1
3545506;Pronto Atendimento;0;0;0;0;0
3545506;Unidade Básica de Saúde;0;0;2;0;2
3545506;Unidade de Saúde Mental ;0;0;0;0;0
3545506;Unidade Móvel;0;0;0;0;0
3545506;Vigilância em Saúde;0;0;0;0;0
3545605;Clínica;0;0;1;2;3
3545605;Consultório Isolado;0;0;0;33;33
3545605;Diagnose e Terapia;0;0;0;3;3
3545605;Hospital;0;0;0;1;1
3545605;Outros;0;0;3;0;3
3545605;Pronto Atendimento;0;0;0;0;0
3545605;Unidade Básica de Saúde;0;0;8;0;8
3545605;Unidade de Saúde Mental ;0;0;0;0;0
3545605;Unidade Móvel;0;0;0;0;0
3545605;Vigilância em Saúde;0;0;0;0;0
3545704;Clínica;0;0;0;0;0
3545704;Consultório Isolado;0;0;0;4;4
3545704;Diagnose e Terapia;0;0;0;2;2
3545704;Hospital;0;0;0;1;1
3545704;Outros;0;0;1;0;1
3545704;Pronto Atendimento;0;0;1;0;1
3545704;Unidade Básica de Saúde;0;0;2;0;2
3545704;Unidade de Saúde Mental ;0;0;0;0;0
3545704;Unidade Móvel;0;0;1;0;1
3545704;Vigilância em Saúde;0;0;0;0;0
3545803;Clínica;1;0;6;24;31
3545803;Consultório Isolado;0;0;0;296;296
3545803;Diagnose e Terapia;0;0;1;33;34
3545803;Hospital;0;0;1;5;6
3545803;Outros;0;0;3;5;8
3545803;Pronto Atendimento;0;0;2;0;2
3545803;Unidade Básica de Saúde;0;0;19;0;19
3545803;Unidade de Saúde Mental ;0;0;3;0;3
3545803;Unidade Móvel;1;0;0;0;1
3545803;Vigilância em Saúde;0;0;2;0;2
3546009;Clínica;0;0;0;2;2
3546009;Consultório Isolado;0;0;0;4;4
3546009;Diagnose e Terapia;0;0;0;3;3
3546009;Hospital;0;0;0;1;1
3546009;Outros;0;0;1;0;1
3546009;Pronto Atendimento;0;0;1;0;1
3546009;Unidade Básica de Saúde;0;0;9;0;9
3546009;Unidade de Saúde Mental ;0;0;0;0;0
3546009;Unidade Móvel;0;0;1;0;1
3546009;Vigilância em Saúde;0;0;2;0;2
3546108;Clínica;0;0;1;0;1
3546108;Consultório Isolado;0;0;0;2;2
3546108;Diagnose e Terapia;0;0;0;0;0
3546108;Hospital;0;0;0;0;0
3546108;Outros;0;0;1;0;1
3546108;Pronto Atendimento;0;0;0;0;0
3546108;Unidade Básica de Saúde;0;0;1;0;1
3546108;Unidade de Saúde Mental ;0;0;0;0;0
3546108;Unidade Móvel;0;0;0;0;0
3546108;Vigilância em Saúde;0;0;0;0;0
3546207;Clínica;0;0;0;0;0
3546207;Consultório Isolado;0;0;0;0;0
3546207;Diagnose e Terapia;0;0;0;1;1
3546207;Hospital;0;0;0;0;0
3546207;Outros;0;0;1;0;1
3546207;Pronto Atendimento;0;0;0;0;0
3546207;Unidade Básica de Saúde;0;0;3;0;3
3546207;Unidade de Saúde Mental ;0;0;0;0;0
3546207;Unidade Móvel;0;0;0;0;0
3546207;Vigilância em Saúde;0;0;0;0;0
3546256;Clínica;0;0;1;0;1
3546256;Consultório Isolado;0;0;0;0;0
3546256;Diagnose e Terapia;0;0;0;0;0
3546256;Hospital;0;0;0;0;0
3546256;Outros;0;0;2;0;2
3546256;Pronto Atendimento;0;0;0;0;0
3546256;Unidade Básica de Saúde;0;0;3;0;3
3546256;Unidade de Saúde Mental ;0;0;0;0;0
3546256;Unidade Móvel;0;0;1;0;1
3546256;Vigilância em Saúde;0;0;1;0;1
3546306;Clínica;0;0;1;9;10
3546306;Consultório Isolado;0;0;0;50;50
3546306;Diagnose e Terapia;0;0;0;8;8
3546306;Hospital;0;0;0;2;2
3546306;Outros;0;0;2;0;2
3546306;Pronto Atendimento;0;0;0;0;0
3546306;Unidade Básica de Saúde;0;0;5;0;5
3546306;Unidade de Saúde Mental ;0;0;1;0;1
3546306;Unidade Móvel;0;0;2;0;2
3546306;Vigilância em Saúde;0;0;0;0;0
3546405;Clínica;0;0;1;16;17
3546405;Consultório Isolado;0;0;0;141;141
3546405;Diagnose e Terapia;0;0;3;17;20
3546405;Hospital;0;0;0;2;2
3546405;Outros;0;0;2;3;5
3546405;Pronto Atendimento;0;0;1;0;1
3546405;Unidade Básica de Saúde;0;0;10;0;10
3546405;Unidade de Saúde Mental ;0;0;1;0;1
3546405;Unidade Móvel;0;0;3;0;3
3546405;Vigilância em Saúde;0;0;0;0;0
3546504;Clínica;0;0;0;0;0
3546504;Consultório Isolado;0;0;0;1;1
3546504;Diagnose e Terapia;0;0;0;0;0
3546504;Hospital;0;0;0;0;0
3546504;Outros;0;0;1;0;1
3546504;Pronto Atendimento;0;0;0;0;0
3546504;Unidade Básica de Saúde;0;0;1;0;1
3546504;Unidade de Saúde Mental ;0;0;0;0;0
3546504;Unidade Móvel;0;0;0;0;0
3546504;Vigilância em Saúde;0;0;0;0;0
3546603;Clínica;1;0;5;43;49
3546603;Consultório Isolado;0;0;0;90;90
3546603;Diagnose e Terapia;0;0;1;8;9
3546603;Hospital;0;0;0;1;1
3546603;Outros;0;0;3;4;7
3546603;Pronto Atendimento;0;0;2;0;2
3546603;Unidade Básica de Saúde;0;0;9;0;9
3546603;Unidade de Saúde Mental ;0;0;1;0;1
3546603;Unidade Móvel;0;0;1;2;3
3546603;Vigilância em Saúde;0;0;1;0;1
3546702;Clínica;0;0;3;5;8
3546702;Consultório Isolado;0;0;1;37;38
3546702;Diagnose e Terapia;0;0;1;3;4
3546702;Hospital;0;0;0;0;0
3546702;Outros;0;0;1;0;1
3546702;Pronto Atendimento;0;0;0;0;0
3546702;Unidade Básica de Saúde;0;0;6;0;6
3546702;Unidade de Saúde Mental ;0;0;1;0;1
3546702;Unidade Móvel;0;0;3;0;3
3546702;Vigilância em Saúde;0;0;1;0;1
3546801;Clínica;0;0;3;6;9
3546801;Consultório Isolado;0;0;0;19;19
3546801;Diagnose e Terapia;0;0;0;3;3
3546801;Hospital;0;0;1;1;2
3546801;Outros;0;0;5;0;5
3546801;Pronto Atendimento;0;0;1;0;1
3546801;Unidade Básica de Saúde;0;0;11;0;11
3546801;Unidade de Saúde Mental ;0;0;1;0;1
3546801;Unidade Móvel;0;0;2;0;2
3546801;Vigilância em Saúde;0;0;0;0;0
3546900;Clínica;0;0;1;2;3
3546900;Consultório Isolado;0;0;0;1;1
3546900;Diagnose e Terapia;0;0;0;0;0
3546900;Hospital;0;0;0;0;0
3546900;Outros;0;0;1;0;1
3546900;Pronto Atendimento;0;0;1;0;1
3546900;Unidade Básica de Saúde;0;0;2;0;2
3546900;Unidade de Saúde Mental ;0;0;0;0;0
3546900;Unidade Móvel;0;0;0;0;0
3546900;Vigilância em Saúde;0;0;0;0;0
3547007;Clínica;0;0;1;0;1
3547007;Consultório Isolado;0;0;0;3;3
3547007;Diagnose e Terapia;0;0;0;0;0
3547007;Hospital;0;0;0;0;0
3547007;Outros;0;0;1;0;1
3547007;Pronto Atendimento;0;0;0;0;0
3547007;Unidade Básica de Saúde;0;0;3;0;3
3547007;Unidade de Saúde Mental ;0;0;0;0;0
3547007;Unidade Móvel;0;0;0;0;0
3547007;Vigilância em Saúde;0;0;1;0;1
3547106;Clínica;0;0;1;0;1
3547106;Consultório Isolado;0;0;0;2;2
3547106;Diagnose e Terapia;0;0;0;0;0
3547106;Hospital;0;0;0;0;0
3547106;Outros;0;0;1;0;1
3547106;Pronto Atendimento;0;0;0;0;0
3547106;Unidade Básica de Saúde;0;0;3;0;3
3547106;Unidade de Saúde Mental ;0;0;0;0;0
3547106;Unidade Móvel;0;0;0;0;0
3547106;Vigilância em Saúde;0;0;0;0;0
3547205;Clínica;0;0;0;0;0
3547205;Consultório Isolado;0;0;0;0;0
3547205;Diagnose e Terapia;0;0;0;0;0
3547205;Hospital;0;0;0;0;0
3547205;Outros;0;0;1;0;1
3547205;Pronto Atendimento;0;0;0;0;0
3547205;Unidade Básica de Saúde;0;0;1;0;1
3547205;Unidade de Saúde Mental ;0;0;0;0;0
3547205;Unidade Móvel;0;0;0;0;0
3547205;Vigilância em Saúde;0;0;0;0;0
3547304;Clínica;0;0;6;9;15
3547304;Consultório Isolado;0;0;0;20;20
3547304;Diagnose e Terapia;0;0;0;8;8
3547304;Hospital;0;0;4;0;4
3547304;Outros;0;0;3;1;4
3547304;Pronto Atendimento;0;0;3;0;3
3547304;Unidade Básica de Saúde;0;0;13;0;13
3547304;Unidade de Saúde Mental ;0;0;3;0;3
3547304;Unidade Móvel;0;0;2;1;3
3547304;Vigilância em Saúde;0;0;2;0;2
3547403;Clínica;0;0;1;0;1
3547403;Consultório Isolado;0;0;0;0;0
3547403;Diagnose e Terapia;0;0;0;0;0
3547403;Hospital;0;0;0;0;0
3547403;Outros;0;0;2;0;2
3547403;Pronto Atendimento;0;0;0;0;0
3547403;Unidade Básica de Saúde;0;0;1;0;1
3547403;Unidade de Saúde Mental ;0;0;0;0;0
3547403;Unidade Móvel;0;0;0;0;0
3547403;Vigilância em Saúde;0;0;0;0;0
3547502;Clínica;0;0;3;7;10
3547502;Consultório Isolado;0;0;0;78;78
3547502;Diagnose e Terapia;0;0;0;5;5
3547502;Hospital;1;0;0;1;2
3547502;Outros;0;0;1;0;1
3547502;Pronto Atendimento;0;0;0;0;0
3547502;Unidade Básica de Saúde;0;0;5;0;5
3547502;Unidade de Saúde Mental ;2;0;0;0;2
3547502;Unidade Móvel;0;0;1;0;1
3547502;Vigilância em Saúde;0;0;0;0;0
3547601;Clínica;0;0;1;9;10
3547601;Consultório Isolado;0;0;0;59;59
3547601;Diagnose e Terapia;0;0;0;7;7
3547601;Hospital;0;0;0;1;1
3547601;Outros;0;0;2;0;2
3547601;Pronto Atendimento;0;0;1;0;1
3547601;Unidade Básica de Saúde;0;0;6;0;6
3547601;Unidade de Saúde Mental ;0;0;1;0;1
3547601;Unidade Móvel;0;0;1;0;1
3547601;Vigilância em Saúde;0;0;2;0;2
3547650;Clínica;0;0;0;0;0
3547650;Consultório Isolado;0;0;0;0;0
3547650;Diagnose e Terapia;0;0;0;0;0
3547650;Hospital;0;0;0;0;0
3547650;Outros;0;0;1;0;1
3547650;Pronto Atendimento;0;0;0;0;0
3547650;Unidade Básica de Saúde;0;0;1;0;1
3547650;Unidade de Saúde Mental ;0;0;0;0;0
3547650;Unidade Móvel;0;0;0;0;0
3547650;Vigilância em Saúde;0;0;0;0;0
3547700;Clínica;0;0;1;1;2
3547700;Consultório Isolado;0;0;0;41;41
3547700;Diagnose e Terapia;0;0;0;2;2
3547700;Hospital;0;0;0;1;1
3547700;Outros;0;0;1;0;1
3547700;Pronto Atendimento;0;0;0;0;0
3547700;Unidade Básica de Saúde;0;0;5;0;5
3547700;Unidade de Saúde Mental ;0;0;0;0;0
3547700;Unidade Móvel;0;0;0;0;0
3547700;Vigilância em Saúde;0;0;0;0;0
3547809;Clínica;0;0;16;459;475
3547809;Consultório Isolado;0;0;0;239;239
3547809;Diagnose e Terapia;1;0;1;58;60
3547809;Hospital;3;0;5;12;20
3547809;Outros;1;0;7;19;27
3547809;Pronto Atendimento;0;0;7;2;9
3547809;Unidade Básica de Saúde;1;0;33;2;36
3547809;Unidade de Saúde Mental ;0;0;5;0;5
3547809;Unidade Móvel;0;0;20;0;20
3547809;Vigilância em Saúde;1;0;1;0;2
3547908;Clínica;0;0;2;1;3
3547908;Consultório Isolado;0;0;0;2;2
3547908;Diagnose e Terapia;0;0;2;1;3
3547908;Hospital;0;0;1;0;1
3547908;Outros;0;0;2;0;2
3547908;Pronto Atendimento;0;0;0;0;0
3547908;Unidade Básica de Saúde;0;0;7;0;7
3547908;Unidade de Saúde Mental ;0;0;0;0;0
3547908;Unidade Móvel;0;0;1;0;1
3547908;Vigilância em Saúde;0;0;2;0;2
3548005;Clínica;0;0;4;7;11
3548005;Consultório Isolado;0;0;0;13;13
3548005;Diagnose e Terapia;0;0;0;0;0
3548005;Hospital;0;0;0;0;0
3548005;Outros;0;0;5;0;5
3548005;Pronto Atendimento;0;0;1;0;1
3548005;Unidade Básica de Saúde;0;0;6;0;6
3548005;Unidade de Saúde Mental ;0;0;1;0;1
3548005;Unidade Móvel;0;0;0;0;0
3548005;Vigilância em Saúde;0;0;1;0;1
3548054;Clínica;0;0;0;0;0
3548054;Consultório Isolado;0;0;0;0;0
3548054;Diagnose e Terapia;0;0;0;0;0
3548054;Hospital;0;0;0;0;0
3548054;Outros;0;0;1;0;1
3548054;Pronto Atendimento;0;0;0;0;0
3548054;Unidade Básica de Saúde;0;0;3;0;3
3548054;Unidade de Saúde Mental ;0;0;0;0;0
3548054;Unidade Móvel;0;0;0;0;0
3548054;Vigilância em Saúde;0;0;0;0;0
3548104;Clínica;0;0;1;0;1
3548104;Consultório Isolado;0;0;0;4;4
3548104;Diagnose e Terapia;0;0;0;2;2
3548104;Hospital;0;0;0;0;0
3548104;Outros;0;0;1;1;2
3548104;Pronto Atendimento;0;0;0;0;0
3548104;Unidade Básica de Saúde;0;0;2;0;2
3548104;Unidade de Saúde Mental ;0;0;0;0;0
3548104;Unidade Móvel;0;0;1;0;1
3548104;Vigilância em Saúde;0;0;0;0;0
3548203;Clínica;0;0;1;0;1
3548203;Consultório Isolado;0;0;0;1;1
3548203;Diagnose e Terapia;0;0;0;0;0
3548203;Hospital;0;0;0;1;1
3548203;Outros;0;0;6;0;6
3548203;Pronto Atendimento;0;0;1;0;1
3548203;Unidade Básica de Saúde;0;0;11;0;11
3548203;Unidade de Saúde Mental ;0;0;0;0;0
3548203;Unidade Móvel;0;0;1;0;1
3548203;Vigilância em Saúde;0;0;0;0;0
3548302;Clínica;0;0;0;0;0
3548302;Consultório Isolado;0;0;0;0;0
3548302;Diagnose e Terapia;0;0;0;0;0
3548302;Hospital;0;0;0;0;0
3548302;Outros;0;0;1;0;1
3548302;Pronto Atendimento;0;0;0;0;0
3548302;Unidade Básica de Saúde;0;0;1;0;1
3548302;Unidade de Saúde Mental ;0;0;0;0;0
3548302;Unidade Móvel;0;0;0;0;0
3548302;Vigilância em Saúde;0;0;0;0;0
3548401;Clínica;0;0;0;1;1
3548401;Consultório Isolado;0;0;0;0;0
3548401;Diagnose e Terapia;0;0;0;0;0
3548401;Hospital;0;0;0;0;0
3548401;Outros;0;0;1;0;1
3548401;Pronto Atendimento;0;0;0;0;0
3548401;Unidade Básica de Saúde;0;0;1;0;1
3548401;Unidade de Saúde Mental ;0;0;0;0;0
3548401;Unidade Móvel;0;0;0;0;0
3548401;Vigilância em Saúde;0;0;1;0;1
3548500;Clínica;3;0;20;211;234
3548500;Consultório Isolado;0;0;0;1622;1622
3548500;Diagnose e Terapia;1;0;2;91;94
3548500;Hospital;1;0;8;21;30
3548500;Outros;4;0;9;16;29
3548500;Pronto Atendimento;0;0;6;3;9
3548500;Unidade Básica de Saúde;1;0;33;0;34
3548500;Unidade de Saúde Mental ;0;0;9;0;9
3548500;Unidade Móvel;0;0;30;7;37
3548500;Vigilância em Saúde;0;0;2;0;2
3548609;Clínica;0;0;0;0;0
3548609;Consultório Isolado;0;0;0;7;7
3548609;Diagnose e Terapia;0;0;0;1;1
3548609;Hospital;0;0;0;1;1
3548609;Outros;0;0;2;0;2
3548609;Pronto Atendimento;0;0;1;0;1
3548609;Unidade Básica de Saúde;0;0;7;0;7
3548609;Unidade de Saúde Mental ;0;0;0;0;0
3548609;Unidade Móvel;0;0;0;0;0
3548609;Vigilância em Saúde;0;0;0;0;0
3548708;Clínica;0;0;15;436;451
3548708;Consultório Isolado;0;0;1;501;502
3548708;Diagnose e Terapia;0;0;2;82;84
3548708;Hospital;0;0;7;23;30
3548708;Outros;1;0;13;25;39
3548708;Pronto Atendimento;0;0;20;3;23
3548708;Unidade Básica de Saúde;1;0;34;1;36
3548708;Unidade de Saúde Mental ;0;0;9;0;9
3548708;Unidade Móvel;0;0;23;4;27
3548708;Vigilância em Saúde;0;0;6;0;6
3548807;Clínica;0;0;19;209;228
3548807;Consultório Isolado;0;0;0;544;544
3548807;Diagnose e Terapia;0;0;3;55;58
3548807;Hospital;0;0;3;8;11
3548807;Outros;1;0;7;15;23
3548807;Pronto Atendimento;0;0;1;1;2
3548807;Unidade Básica de Saúde;0;0;15;0;15
3548807;Unidade de Saúde Mental ;0;0;2;0;2
3548807;Unidade Móvel;0;0;7;3;10
3548807;Vigilância em Saúde;0;0;3;0;3
3548906;Clínica;1;1;4;123;129
3548906;Consultório Isolado;0;0;1;686;687
3548906;Diagnose e Terapia;0;2;1;46;49
3548906;Hospital;0;1;1;5;7
3548906;Outros;0;0;4;7;11
3548906;Pronto Atendimento;0;0;4;1;5
3548906;Unidade Básica de Saúde;1;0;35;0;36
3548906;Unidade de Saúde Mental ;0;0;3;0;3
3548906;Unidade Móvel;1;0;10;2;13
3548906;Vigilância em Saúde;0;0;2;0;2
3549003;Clínica;0;0;0;0;0
3549003;Consultório Isolado;0;0;0;1;1
3549003;Diagnose e Terapia;0;0;0;0;0
3549003;Hospital;0;0;0;0;0
3549003;Outros;0;0;2;0;2
3549003;Pronto Atendimento;0;0;0;0;0
3549003;Unidade Básica de Saúde;0;0;2;0;2
3549003;Unidade de Saúde Mental ;0;0;0;0;0
3549003;Unidade Móvel;0;0;0;0;0
3549003;Vigilância em Saúde;0;0;0;0;0
3549102;Clínica;3;0;8;27;38
3549102;Consultório Isolado;0;0;0;634;634
3549102;Diagnose e Terapia;0;0;3;17;20
3549102;Hospital;0;0;0;4;4
3549102;Outros;3;0;6;15;24
3549102;Pronto Atendimento;0;0;2;0;2
3549102;Unidade Básica de Saúde;0;0;13;0;13
3549102;Unidade de Saúde Mental ;0;0;3;0;3
3549102;Unidade Móvel;0;0;3;3;6
3549102;Vigilância em Saúde;0;0;4;0;4
3549201;Clínica;0;0;0;0;0
3549201;Consultório Isolado;0;0;0;0;0
3549201;Diagnose e Terapia;0;0;0;0;0
3549201;Hospital;0;0;0;0;0
3549201;Outros;0;0;1;0;1
3549201;Pronto Atendimento;0;0;0;0;0
3549201;Unidade Básica de Saúde;0;0;2;0;2
3549201;Unidade de Saúde Mental ;0;0;0;0;0
3549201;Unidade Móvel;0;0;0;0;0
3549201;Vigilância em Saúde;0;0;0;0;0
3549250;Clínica;0;0;1;0;1
3549250;Consultório Isolado;0;0;0;0;0
3549250;Diagnose e Terapia;0;0;0;0;0
3549250;Hospital;0;0;0;0;0
3549250;Outros;0;0;2;0;2
3549250;Pronto Atendimento;0;0;0;0;0
3549250;Unidade Básica de Saúde;0;0;2;0;2
3549250;Unidade de Saúde Mental ;0;0;0;0;0
3549250;Unidade Móvel;0;0;0;0;0
3549250;Vigilância em Saúde;0;0;0;0;0
3549300;Clínica;0;0;1;0;1
3549300;Consultório Isolado;0;0;0;2;2
3549300;Diagnose e Terapia;0;0;0;0;0
3549300;Hospital;0;0;0;0;0
3549300;Outros;0;0;2;0;2
3549300;Pronto Atendimento;0;0;0;0;0
3549300;Unidade Básica de Saúde;0;0;1;0;1
3549300;Unidade de Saúde Mental ;0;0;0;0;0
3549300;Unidade Móvel;0;0;0;0;0
3549300;Vigilância em Saúde;0;0;0;0;0
3549409;Clínica;0;0;4;5;9
3549409;Consultório Isolado;0;0;0;203;203
3549409;Diagnose e Terapia;0;0;2;39;41
3549409;Hospital;0;0;1;1;2
3549409;Outros;0;0;1;0;1
3549409;Pronto Atendimento;0;0;2;0;2
3549409;Unidade Básica de Saúde;0;0;11;0;11
3549409;Unidade de Saúde Mental ;0;0;1;0;1
3549409;Unidade Móvel;0;0;1;0;1
3549409;Vigilância em Saúde;0;0;1;0;1
3549508;Clínica;0;0;1;1;2
3549508;Consultório Isolado;0;0;0;4;4
3549508;Diagnose e Terapia;0;0;0;0;0
3549508;Hospital;0;0;0;0;0
3549508;Outros;0;0;1;0;1
3549508;Pronto Atendimento;0;0;1;0;1
3549508;Unidade Básica de Saúde;0;0;4;0;4
3549508;Unidade de Saúde Mental ;0;0;0;0;0
3549508;Unidade Móvel;0;0;0;0;0
3549508;Vigilância em Saúde;0;0;0;0;0
3549607;Clínica;0;0;0;0;0
3549607;Consultório Isolado;0;0;0;1;1
3549607;Diagnose e Terapia;0;0;0;0;0
3549607;Hospital;0;0;0;0;0
3549607;Outros;0;0;1;0;1
3549607;Pronto Atendimento;0;0;0;0;0
3549607;Unidade Básica de Saúde;0;0;4;0;4
3549607;Unidade de Saúde Mental ;0;0;0;0;0
3549607;Unidade Móvel;0;0;0;0;0
3549607;Vigilância em Saúde;0;0;0;0;0
3549706;Clínica;0;0;6;35;41
3549706;Consultório Isolado;0;0;0;143;143
3549706;Diagnose e Terapia;0;0;3;30;33
3549706;Hospital;0;0;0;2;2
3549706;Outros;0;0;1;5;6
3549706;Pronto Atendimento;0;0;1;0;1
3549706;Unidade Básica de Saúde;0;0;11;0;11
3549706;Unidade de Saúde Mental ;0;0;1;0;1
3549706;Unidade Móvel;0;0;2;0;2
3549706;Vigilância em Saúde;0;0;1;0;1
3549805;Clínica;4;0;14;239;257
3549805;Consultório Isolado;0;0;7;909;916
3549805;Diagnose e Terapia;2;0;2;141;145
3549805;Hospital;1;0;1;26;28
3549805;Outros;6;0;12;18;36
3549805;Pronto Atendimento;0;0;8;0;8
3549805;Unidade Básica de Saúde;3;0;27;0;30
3549805;Unidade de Saúde Mental ;0;0;7;0;7
3549805;Unidade Móvel;0;0;28;1;29
3549805;Vigilância em Saúde;1;0;3;0;4
3549904;Clínica;4;0;17;221;242
3549904;Consultório Isolado;0;0;0;1760;1760
3549904;Diagnose e Terapia;0;0;1;111;112
3549904;Hospital;1;1;3;25;30
3549904;Outros;2;0;5;26;33
3549904;Pronto Atendimento;0;0;7;2;9
3549904;Unidade Básica de Saúde;2;0;40;0;42
3549904;Unidade de Saúde Mental ;0;0;5;0;5
3549904;Unidade Móvel;0;0;9;9;18
3549904;Vigilância em Saúde;1;0;3;0;4
3549953;Clínica;0;0;1;1;2
3549953;Consultório Isolado;0;0;0;0;0
3549953;Diagnose e Terapia;0;0;0;1;1
3549953;Hospital;0;0;0;0;0
3549953;Outros;0;0;1;0;1
3549953;Pronto Atendimento;0;0;1;0;1
3549953;Unidade Básica de Saúde;0;0;3;0;3
3549953;Unidade de Saúde Mental ;0;0;0;0;0
3549953;Unidade Móvel;0;0;1;2;3
3549953;Vigilância em Saúde;0;0;0;0;0
3550001;Clínica;0;0;0;0;0
3550001;Consultório Isolado;0;0;0;6;6
3550001;Diagnose e Terapia;0;0;0;0;0
3550001;Hospital;0;0;0;1;1
3550001;Outros;0;0;2;0;2
3550001;Pronto Atendimento;0;0;0;0;0
3550001;Unidade Básica de Saúde;0;0;4;0;4
3550001;Unidade de Saúde Mental ;0;0;0;0;0
3550001;Unidade Móvel;0;0;1;0;1
3550001;Vigilância em Saúde;0;0;0;0;0
3550100;Clínica;0;0;2;2;4
3550100;Consultório Isolado;0;0;1;128;129
3550100;Diagnose e Terapia;0;0;1;7;8
3550100;Hospital;0;0;0;1;1
3550100;Outros;0;0;1;0;1
3550100;Pronto Atendimento;0;0;0;0;0
3550100;Unidade Básica de Saúde;0;0;8;0;8
3550100;Unidade de Saúde Mental ;0;0;1;0;1
3550100;Unidade Móvel;0;0;0;1;1
3550100;Vigilância em Saúde;0;0;1;0;1
3550209;Clínica;0;0;2;2;4
3550209;Consultório Isolado;0;0;0;40;40
3550209;Diagnose e Terapia;0;0;0;4;4
3550209;Hospital;0;0;0;1;1
3550209;Outros;0;0;3;14;17
3550209;Pronto Atendimento;0;0;0;1;1
3550209;Unidade Básica de Saúde;0;0;13;0;13
3550209;Unidade de Saúde Mental ;0;0;1;0;1
3550209;Unidade Móvel;0;0;2;0;2
3550209;Vigilância em Saúde;0;0;1;0;1
3550308;Clínica;22;1;192;5992;6207
3550308;Consultório Isolado;40;4;3;17095;17142
3550308;Diagnose e Terapia;9;0;15;1208;1232
3550308;Hospital;40;2;48;219;309
3550308;Outros;31;11;38;546;626
3550308;Pronto Atendimento;0;0;41;32;73
3550308;Unidade Básica de Saúde;11;0;606;35;652
3550308;Unidade de Saúde Mental ;2;0;99;0;101
3550308;Unidade Móvel;1;0;183;104;288
3550308;Vigilância em Saúde;0;0;36;0;36
3550407;Clínica;0;0;2;5;7
3550407;Consultório Isolado;0;0;0;72;72
3550407;Diagnose e Terapia;0;0;0;6;6
3550407;Hospital;0;0;0;2;2
3550407;Outros;0;0;1;3;4
3550407;Pronto Atendimento;0;0;1;0;1
3550407;Unidade Básica de Saúde;0;0;11;0;11
3550407;Unidade de Saúde Mental ;0;0;1;0;1
3550407;Unidade Móvel;0;0;0;0;0
3550407;Vigilância em Saúde;0;0;0;0;0
3550506;Clínica;0;0;0;0;0
3550506;Consultório Isolado;0;0;0;1;1
3550506;Diagnose e Terapia;0;0;0;0;0
3550506;Hospital;0;0;0;0;0
3550506;Outros;0;0;2;0;2
3550506;Pronto Atendimento;0;0;0;0;0
3550506;Unidade Básica de Saúde;0;0;3;0;3
3550506;Unidade de Saúde Mental ;0;0;0;0;0
3550506;Unidade Móvel;0;0;0;0;0
3550506;Vigilância em Saúde;0;0;0;0;0
3550605;Clínica;0;0;3;34;37
3550605;Consultório Isolado;0;0;1;244;245
3550605;Diagnose e Terapia;0;0;0;17;17
3550605;Hospital;0;0;0;5;5
3550605;Outros;0;0;2;20;22
3550605;Pronto Atendimento;0;0;0;0;0
3550605;Unidade Básica de Saúde;0;0;11;0;11
3550605;Unidade de Saúde Mental ;0;0;1;0;1
3550605;Unidade Móvel;0;0;0;0;0
3550605;Vigilância em Saúde;0;0;3;0;3
3550704;Clínica;0;0;5;1;6
3550704;Consultório Isolado;0;0;1;139;140
3550704;Diagnose e Terapia;0;0;1;14;15
3550704;Hospital;0;0;2;1;3
3550704;Outros;0;0;7;2;9
3550704;Pronto Atendimento;0;0;2;0;2
3550704;Unidade Básica de Saúde;0;0;31;0;31
3550704;Unidade de Saúde Mental ;0;0;2;0;2
3550704;Unidade Móvel;0;0;6;0;6
3550704;Vigilância em Saúde;0;0;3;0;3
3550803;Clínica;0;0;1;2;3
3550803;Consultório Isolado;0;0;0;17;17
3550803;Diagnose e Terapia;0;0;0;5;5
3550803;Hospital;0;0;0;1;1
3550803;Outros;0;0;2;0;2
3550803;Pronto Atendimento;0;0;1;0;1
3550803;Unidade Básica de Saúde;0;0;6;0;6
3550803;Unidade de Saúde Mental ;0;0;0;0;0
3550803;Unidade Móvel;0;0;0;0;0
3550803;Vigilância em Saúde;0;0;1;0;1
3550902;Clínica;0;0;4;4;8
3550902;Consultório Isolado;0;0;0;26;26
3550902;Diagnose e Terapia;0;0;0;3;3
3550902;Hospital;0;0;0;1;1
3550902;Outros;0;0;2;0;2
3550902;Pronto Atendimento;0;0;0;0;0
3550902;Unidade Básica de Saúde;0;0;5;0;5
3550902;Unidade de Saúde Mental ;0;0;0;0;0
3550902;Unidade Móvel;0;0;1;0;1
3550902;Vigilância em Saúde;0;0;2;0;2
3551009;Clínica;1;0;14;43;58
3551009;Consultório Isolado;0;0;1;186;187
3551009;Diagnose e Terapia;0;0;3;18;21
3551009;Hospital;0;0;4;3;7
3551009;Outros;0;0;8;2;10
3551009;Pronto Atendimento;0;0;3;1;4
3551009;Unidade Básica de Saúde;4;0;31;0;35
3551009;Unidade de Saúde Mental ;0;0;5;0;5
3551009;Unidade Móvel;0;0;10;0;10
3551009;Vigilância em Saúde;1;0;1;0;2
3551108;Clínica;0;0;0;0;0
3551108;Consultório Isolado;0;0;0;4;4
3551108;Diagnose e Terapia;0;0;0;2;2
3551108;Hospital;0;0;0;0;0
3551108;Outros;0;0;2;0;2
3551108;Pronto Atendimento;0;0;0;0;0
3551108;Unidade Básica de Saúde;0;0;3;0;3
3551108;Unidade de Saúde Mental ;0;0;0;0;0
3551108;Unidade Móvel;0;0;1;0;1
3551108;Vigilância em Saúde;0;0;1;0;1
3551207;Clínica;0;0;0;0;0
3551207;Consultório Isolado;0;0;0;0;0
3551207;Diagnose e Terapia;0;0;0;0;0
3551207;Hospital;0;0;0;0;0
3551207;Outros;0;0;1;0;1
3551207;Pronto Atendimento;0;0;0;0;0
3551207;Unidade Básica de Saúde;0;0;1;0;1
3551207;Unidade de Saúde Mental ;0;0;0;0;0
3551207;Unidade Móvel;0;0;0;0;0
3551207;Vigilância em Saúde;0;0;0;0;0
3551306;Clínica;0;0;0;1;1
3551306;Consultório Isolado;0;0;0;0;0
3551306;Diagnose e Terapia;0;0;0;0;0
3551306;Hospital;0;0;0;0;0
3551306;Outros;0;0;1;1;2
3551306;Pronto Atendimento;0;0;0;0;0
3551306;Unidade Básica de Saúde;0;0;1;0;1
3551306;Unidade de Saúde Mental ;0;0;0;0;0
3551306;Unidade Móvel;0;0;0;0;0
3551306;Vigilância em Saúde;0;0;0;0;0
3551405;Clínica;0;0;1;1;2
3551405;Consultório Isolado;0;0;0;4;4
3551405;Diagnose e Terapia;0;0;0;1;1
3551405;Hospital;0;0;0;0;0
3551405;Outros;0;0;1;0;1
3551405;Pronto Atendimento;0;0;0;0;0
3551405;Unidade Básica de Saúde;3;0;5;0;8
3551405;Unidade de Saúde Mental ;0;0;0;0;0
3551405;Unidade Móvel;0;0;1;0;1
3551405;Vigilância em Saúde;0;0;1;0;1
3551504;Clínica;0;0;6;9;15
3551504;Consultório Isolado;0;0;0;29;29
3551504;Diagnose e Terapia;0;0;0;2;2
3551504;Hospital;1;0;0;1;2
3551504;Outros;0;0;4;1;5
3551504;Pronto Atendimento;0;0;1;0;1
3551504;Unidade Básica de Saúde;0;0;8;0;8
3551504;Unidade de Saúde Mental ;0;0;0;0;0
3551504;Unidade Móvel;0;0;1;0;1
3551504;Vigilância em Saúde;0;0;2;0;2
3551603;Clínica;0;0;3;7;10
3551603;Consultório Isolado;0;0;0;54;54
3551603;Diagnose e Terapia;0;0;1;5;6
3551603;Hospital;0;0;0;1;1
3551603;Outros;0;0;3;2;5
3551603;Pronto Atendimento;0;0;1;0;1
3551603;Unidade Básica de Saúde;0;0;10;3;13
3551603;Unidade de Saúde Mental ;0;0;1;0;1
3551603;Unidade Móvel;0;0;0;0;0
3551603;Vigilância em Saúde;0;0;1;0;1
3551702;Clínica;0;0;8;65;73
3551702;Consultório Isolado;0;0;1;297;298
3551702;Diagnose e Terapia;0;0;1;27;28
3551702;Hospital;0;0;0;3;3
3551702;Outros;0;0;7;3;10
3551702;Pronto Atendimento;0;0;1;1;2
3551702;Unidade Básica de Saúde;0;0;10;4;14
3551702;Unidade de Saúde Mental ;0;0;2;0;2
3551702;Unidade Móvel;0;0;3;0;3
3551702;Vigilância em Saúde;0;0;5;0;5
3551801;Clínica;0;0;0;1;1
3551801;Consultório Isolado;0;0;0;1;1
3551801;Diagnose e Terapia;0;0;0;0;0
3551801;Hospital;0;0;0;0;0
3551801;Outros;0;0;1;0;1
3551801;Pronto Atendimento;0;0;1;0;1
3551801;Unidade Básica de Saúde;0;0;5;0;5
3551801;Unidade de Saúde Mental ;0;0;0;0;0
3551801;Unidade Móvel;0;0;1;0;1
3551801;Vigilância em Saúde;0;0;0;0;0
3551900;Clínica;0;0;0;3;3
3551900;Consultório Isolado;0;0;0;5;5
3551900;Diagnose e Terapia;0;0;1;2;3
3551900;Hospital;0;0;0;0;0
3551900;Outros;0;0;3;0;3
3551900;Pronto Atendimento;0;0;1;0;1
3551900;Unidade Básica de Saúde;0;0;3;0;3
3551900;Unidade de Saúde Mental ;0;0;0;0;0
3551900;Unidade Móvel;0;0;1;0;1
3551900;Vigilância em Saúde;0;0;0;0;0
3552007;Clínica;0;0;0;0;0
3552007;Consultório Isolado;0;0;0;6;6
3552007;Diagnose e Terapia;0;0;1;0;1
3552007;Hospital;0;0;0;0;0
3552007;Outros;0;0;1;0;1
3552007;Pronto Atendimento;0;0;0;0;0
3552007;Unidade Básica de Saúde;0;0;4;0;4
3552007;Unidade de Saúde Mental ;0;0;0;0;0
3552007;Unidade Móvel;0;0;0;0;0
3552007;Vigilância em Saúde;0;0;0;0;0
3552106;Clínica;0;0;2;4;6
3552106;Consultório Isolado;0;0;0;55;55
3552106;Diagnose e Terapia;0;0;1;6;7
3552106;Hospital;0;0;0;1;1
3552106;Outros;0;0;4;1;5
3552106;Pronto Atendimento;0;0;0;0;0
3552106;Unidade Básica de Saúde;0;0;15;0;15
3552106;Unidade de Saúde Mental ;0;0;2;0;2
3552106;Unidade Móvel;0;0;1;0;1
3552106;Vigilância em Saúde;0;0;1;0;1
3552205;Clínica;3;0;4;222;229
3552205;Consultório Isolado;0;0;1;902;903
3552205;Diagnose e Terapia;1;0;2;112;115
3552205;Hospital;3;0;7;21;31
3552205;Outros;5;0;5;22;32
3552205;Pronto Atendimento;0;0;3;3;6
3552205;Unidade Básica de Saúde;5;0;34;0;39
3552205;Unidade de Saúde Mental ;0;0;10;1;11
3552205;Unidade Móvel;0;0;21;6;27
3552205;Vigilância em Saúde;0;0;4;0;4
3552304;Clínica;0;0;0;0;0
3552304;Consultório Isolado;0;0;3;4;7
3552304;Diagnose e Terapia;0;0;1;1;2
3552304;Hospital;0;0;0;1;1
3552304;Outros;0;0;1;0;1
3552304;Pronto Atendimento;0;0;0;0;0
3552304;Unidade Básica de Saúde;0;0;3;0;3
3552304;Unidade de Saúde Mental ;0;0;0;0;0
3552304;Unidade Móvel;0;0;0;0;0
3552304;Vigilância em Saúde;0;0;1;0;1
3552403;Clínica;0;0;7;70;77
3552403;Consultório Isolado;0;0;0;131;131
3552403;Diagnose e Terapia;0;0;0;36;36
3552403;Hospital;1;0;1;3;5
3552403;Outros;0;0;7;3;10
3552403;Pronto Atendimento;0;0;5;2;7
3552403;Unidade Básica de Saúde;1;0;24;1;26
3552403;Unidade de Saúde Mental ;0;0;3;0;3
3552403;Unidade Móvel;0;0;5;0;5
3552403;Vigilância em Saúde;0;0;4;0;4
3552502;Clínica;0;0;6;106;112
3552502;Consultório Isolado;0;0;0;156;156
3552502;Diagnose e Terapia;0;0;1;29;30
3552502;Hospital;0;0;3;7;10
3552502;Outros;0;0;9;1;10
3552502;Pronto Atendimento;0;0;3;1;4
3552502;Unidade Básica de Saúde;1;0;24;0;25
3552502;Unidade de Saúde Mental ;0;0;4;0;4
3552502;Unidade Móvel;0;0;9;0;9
3552502;Vigilância em Saúde;0;0;2;0;2
3552551;Clínica;0;0;0;0;0
3552551;Consultório Isolado;0;0;0;3;3
3552551;Diagnose e Terapia;0;0;0;0;0
3552551;Hospital;0;0;0;0;0
3552551;Outros;0;0;2;0;2
3552551;Pronto Atendimento;0;0;0;0;0
3552551;Unidade Básica de Saúde;0;0;1;0;1
3552551;Unidade de Saúde Mental ;0;0;0;0;0
3552551;Unidade Móvel;0;0;0;0;0
3552551;Vigilância em Saúde;0;0;0;0;0
3552601;Clínica;0;0;2;1;3
3552601;Consultório Isolado;0;0;0;15;15
3552601;Diagnose e Terapia;0;0;1;2;3
3552601;Hospital;0;0;0;1;1
3552601;Outros;0;0;1;0;1
3552601;Pronto Atendimento;0;0;0;0;0
3552601;Unidade Básica de Saúde;0;0;3;0;3
3552601;Unidade de Saúde Mental ;0;0;0;0;0
3552601;Unidade Móvel;0;0;1;0;1
3552601;Vigilância em Saúde;0;0;1;0;1
3552700;Clínica;0;0;0;7;7
3552700;Consultório Isolado;0;0;0;42;42
3552700;Diagnose e Terapia;0;0;1;7;8
3552700;Hospital;0;0;0;1;1
3552700;Outros;0;0;1;0;1
3552700;Pronto Atendimento;0;0;1;0;1
3552700;Unidade Básica de Saúde;0;0;4;0;4
3552700;Unidade de Saúde Mental ;0;0;0;0;0
3552700;Unidade Móvel;0;0;0;0;0
3552700;Vigilância em Saúde;0;0;1;0;1
3552809;Clínica;1;0;9;42;52
3552809;Consultório Isolado;0;0;0;88;88
3552809;Diagnose e Terapia;0;0;0;8;8
3552809;Hospital;1;0;3;4;8
3552809;Outros;0;0;5;2;7
3552809;Pronto Atendimento;0;0;4;0;4
3552809;Unidade Básica de Saúde;0;0;14;0;14
3552809;Unidade de Saúde Mental ;0;0;3;0;3
3552809;Unidade Móvel;0;0;5;0;5
3552809;Vigilância em Saúde;0;0;5;0;5
3552908;Clínica;0;0;1;0;1
3552908;Consultório Isolado;0;0;1;0;1
3552908;Diagnose e Terapia;0;0;0;0;0
3552908;Hospital;0;0;0;0;0
3552908;Outros;0;0;1;0;1
3552908;Pronto Atendimento;0;0;0;0;0
3552908;Unidade Básica de Saúde;0;0;3;0;3
3552908;Unidade de Saúde Mental ;0;0;0;0;0
3552908;Unidade Móvel;0;0;0;0;0
3552908;Vigilância em Saúde;0;0;0;0;0
3553005;Clínica;0;0;0;0;0
3553005;Consultório Isolado;0;0;0;6;6
3553005;Diagnose e Terapia;0;0;0;2;2
3553005;Hospital;0;0;0;1;1
3553005;Outros;0;0;1;0;1
3553005;Pronto Atendimento;0;0;0;0;0
3553005;Unidade Básica de Saúde;0;0;5;0;5
3553005;Unidade de Saúde Mental ;0;0;0;0;0
3553005;Unidade Móvel;0;0;1;0;1
3553005;Vigilância em Saúde;0;0;1;0;1
3553104;Clínica;0;0;1;1;2
3553104;Consultório Isolado;0;0;0;4;4
3553104;Diagnose e Terapia;0;0;0;1;1
3553104;Hospital;0;0;0;0;0
3553104;Outros;0;0;2;0;2
3553104;Pronto Atendimento;0;0;0;0;0
3553104;Unidade Básica de Saúde;0;0;3;0;3
3553104;Unidade de Saúde Mental ;0;0;0;0;0
3553104;Unidade Móvel;0;0;0;0;0
3553104;Vigilância em Saúde;0;0;0;0;0
3553203;Clínica;0;0;0;0;0
3553203;Consultório Isolado;0;0;0;9;9
3553203;Diagnose e Terapia;0;0;0;5;5
3553203;Hospital;0;0;0;0;0
3553203;Outros;0;0;1;0;1
3553203;Pronto Atendimento;0;0;0;0;0
3553203;Unidade Básica de Saúde;1;0;4;0;5
3553203;Unidade de Saúde Mental ;0;0;0;0;0
3553203;Unidade Móvel;0;0;0;0;0
3553203;Vigilância em Saúde;0;0;0;0;0
3553302;Clínica;0;0;2;3;5
3553302;Consultório Isolado;0;0;0;62;62
3553302;Diagnose e Terapia;0;0;0;10;10
3553302;Hospital;0;0;0;1;1
3553302;Outros;0;0;4;6;10
3553302;Pronto Atendimento;0;0;1;0;1
3553302;Unidade Básica de Saúde;0;0;10;0;10
3553302;Unidade de Saúde Mental ;0;0;0;0;0
3553302;Unidade Móvel;0;0;1;0;1
3553302;Vigilância em Saúde;0;0;0;0;0
3553401;Clínica;1;0;1;13;15
3553401;Consultório Isolado;0;0;0;21;21
3553401;Diagnose e Terapia;0;0;0;4;4
3553401;Hospital;0;0;0;1;1
3553401;Outros;0;0;1;0;1
3553401;Pronto Atendimento;0;0;0;0;0
3553401;Unidade Básica de Saúde;0;0;10;0;10
3553401;Unidade de Saúde Mental ;0;0;1;0;1
3553401;Unidade Móvel;0;0;1;0;1
3553401;Vigilância em Saúde;0;0;0;0;0
3553500;Clínica;0;0;1;0;1
3553500;Consultório Isolado;0;0;2;1;3
3553500;Diagnose e Terapia;0;0;0;1;1
3553500;Hospital;0;0;0;1;1
3553500;Outros;0;0;3;0;3
3553500;Pronto Atendimento;0;0;0;1;1
3553500;Unidade Básica de Saúde;0;0;3;0;3
3553500;Unidade de Saúde Mental ;0;0;0;0;0
3553500;Unidade Móvel;0;0;0;0;0
3553500;Vigilância em Saúde;0;0;0;0;0
3553609;Clínica;0;0;0;1;1
3553609;Consultório Isolado;0;0;0;6;6
3553609;Diagnose e Terapia;0;0;1;1;2
3553609;Hospital;0;0;0;1;1
3553609;Outros;0;0;2;1;3
3553609;Pronto Atendimento;0;0;0;0;0
3553609;Unidade Básica de Saúde;0;0;7;0;7
3553609;Unidade de Saúde Mental ;0;0;1;0;1
3553609;Unidade Móvel;0;0;0;0;0
3553609;Vigilância em Saúde;0;0;0;0;0
3553658;Clínica;0;0;0;0;0
3553658;Consultório Isolado;0;0;0;0;0
3553658;Diagnose e Terapia;0;0;0;0;0
3553658;Hospital;0;0;0;0;0
3553658;Outros;0;0;2;0;2
3553658;Pronto Atendimento;0;0;0;0;0
3553658;Unidade Básica de Saúde;0;0;1;0;1
3553658;Unidade de Saúde Mental ;0;0;0;0;0
3553658;Unidade Móvel;0;0;0;0;0
3553658;Vigilância em Saúde;0;0;0;0;0
3553708;Clínica;1;0;6;7;14
3553708;Consultório Isolado;1;0;0;134;135
3553708;Diagnose e Terapia;0;0;0;10;10
3553708;Hospital;0;0;0;2;2
3553708;Outros;0;0;2;3;5
3553708;Pronto Atendimento;0;0;1;0;1
3553708;Unidade Básica de Saúde;0;0;11;0;11
3553708;Unidade de Saúde Mental ;0;0;2;0;2
3553708;Unidade Móvel;0;0;2;0;2
3553708;Vigilância em Saúde;0;0;1;0;1
3553807;Clínica;0;0;0;0;0
3553807;Consultório Isolado;0;0;0;7;7
3553807;Diagnose e Terapia;0;0;1;6;7
3553807;Hospital;0;0;0;1;1
3553807;Outros;0;0;1;0;1
3553807;Pronto Atendimento;0;0;0;0;0
3553807;Unidade Básica de Saúde;1;0;6;0;7
3553807;Unidade de Saúde Mental ;0;0;0;0;0
3553807;Unidade Móvel;0;0;1;0;1
3553807;Vigilância em Saúde;0;0;1;0;1
3553856;Clínica;0;0;0;0;0
3553856;Consultório Isolado;0;0;0;0;0
3553856;Diagnose e Terapia;0;0;0;0;0
3553856;Hospital;0;0;0;0;0
3553856;Outros;0;0;2;0;2
3553856;Pronto Atendimento;0;0;1;0;1
3553856;Unidade Básica de Saúde;0;0;3;0;3
3553856;Unidade de Saúde Mental ;0;0;0;0;0
3553856;Unidade Móvel;0;0;0;0;0
3553856;Vigilância em Saúde;0;0;1;0;1
3553906;Clínica;0;0;1;0;1
3553906;Consultório Isolado;0;0;0;1;1
3553906;Diagnose e Terapia;0;0;0;0;0
3553906;Hospital;0;0;0;0;0
3553906;Outros;0;0;1;0;1
3553906;Pronto Atendimento;0;0;0;0;0
3553906;Unidade Básica de Saúde;0;0;4;0;4
3553906;Unidade de Saúde Mental ;0;0;1;0;1
3553906;Unidade Móvel;0;0;0;0;0
3553906;Vigilância em Saúde;0;0;0;0;0
3553955;Clínica;0;0;3;0;3
3553955;Consultório Isolado;0;0;0;3;3
3553955;Diagnose e Terapia;0;0;2;4;6
3553955;Hospital;0;0;0;0;0
3553955;Outros;0;0;3;0;3
3553955;Pronto Atendimento;0;0;1;0;1
3553955;Unidade Básica de Saúde;0;0;4;0;4
3553955;Unidade de Saúde Mental ;0;0;1;0;1
3553955;Unidade Móvel;0;0;1;0;1
3553955;Vigilância em Saúde;0;0;0;0;0
3554003;Clínica;0;0;11;34;45
3554003;Consultório Isolado;0;0;2;370;372
3554003;Diagnose e Terapia;0;0;1;25;26
3554003;Hospital;0;0;0;2;2
3554003;Outros;0;0;5;3;8
3554003;Pronto Atendimento;0;0;2;1;3
3554003;Unidade Básica de Saúde;0;0;22;0;22
3554003;Unidade de Saúde Mental ;0;0;2;0;2
3554003;Unidade Móvel;0;0;6;1;7
3554003;Vigilância em Saúde;0;0;2;0;2
3554102;Clínica;1;0;12;220;233
3554102;Consultório Isolado;0;0;1;575;576
3554102;Diagnose e Terapia;1;0;1;50;52
3554102;Hospital;0;0;2;10;12
3554102;Outros;3;0;8;12;23
3554102;Pronto Atendimento;0;0;5;0;5
3554102;Unidade Básica de Saúde;3;0;55;0;58
3554102;Unidade de Saúde Mental ;0;0;3;0;3
3554102;Unidade Móvel;0;0;11;3;14
3554102;Vigilância em Saúde;0;0;5;0;5
3554201;Clínica;0;0;0;0;0
3554201;Consultório Isolado;0;0;0;0;0
3554201;Diagnose e Terapia;0;0;0;0;0
3554201;Hospital;0;0;0;0;0
3554201;Outros;0;0;1;0;1
3554201;Pronto Atendimento;0;0;0;0;0
3554201;Unidade Básica de Saúde;0;0;3;0;3
3554201;Unidade de Saúde Mental ;0;0;0;0;0
3554201;Unidade Móvel;0;0;0;0;0
3554201;Vigilância em Saúde;0;0;0;0;0
3554300;Clínica;0;0;0;4;4
3554300;Consultório Isolado;0;0;6;23;29
3554300;Diagnose e Terapia;0;0;2;3;5
3554300;Hospital;0;0;0;1;1
3554300;Outros;0;0;2;0;2
3554300;Pronto Atendimento;0;0;0;0;0
3554300;Unidade Básica de Saúde;0;0;12;0;12
3554300;Unidade de Saúde Mental ;0;0;0;0;0
3554300;Unidade Móvel;0;0;0;0;0
3554300;Vigilância em Saúde;0;0;1;0;1
3554409;Clínica;0;0;2;0;2
3554409;Consultório Isolado;0;0;0;8;8
3554409;Diagnose e Terapia;0;0;1;0;1
3554409;Hospital;0;0;0;1;1
3554409;Outros;0;0;2;0;2
3554409;Pronto Atendimento;0;0;1;0;1
3554409;Unidade Básica de Saúde;0;0;4;0;4
3554409;Unidade de Saúde Mental ;0;0;0;0;0
3554409;Unidade Móvel;0;0;0;0;0
3554409;Vigilância em Saúde;0;0;0;0;0
3554508;Clínica;0;0;2;11;13
3554508;Consultório Isolado;0;0;0;129;129
3554508;Diagnose e Terapia;0;0;1;21;22
3554508;Hospital;0;0;0;1;1
3554508;Outros;0;0;5;2;7
3554508;Pronto Atendimento;0;0;0;0;0
3554508;Unidade Básica de Saúde;0;0;8;0;8
3554508;Unidade de Saúde Mental ;0;0;1;0;1
3554508;Unidade Móvel;0;0;0;1;1
3554508;Vigilância em Saúde;0;0;1;0;1
3554607;Clínica;0;0;0;0;0
3554607;Consultório Isolado;0;0;0;0;0
3554607;Diagnose e Terapia;0;0;0;0;0
3554607;Hospital;0;0;0;0;0
3554607;Outros;0;0;1;0;1
3554607;Pronto Atendimento;0;0;0;0;0
3554607;Unidade Básica de Saúde;0;0;1;0;1
3554607;Unidade de Saúde Mental ;0;0;0;0;0
3554607;Unidade Móvel;0;0;1;0;1
3554607;Vigilância em Saúde;0;0;0;0;0
3554656;Clínica;0;0;0;0;0
3554656;Consultório Isolado;0;0;0;0;0
3554656;Diagnose e Terapia;0;0;0;0;0
3554656;Hospital;0;0;0;0;0
3554656;Outros;0;0;2;1;3
3554656;Pronto Atendimento;0;0;0;0;0
3554656;Unidade Básica de Saúde;0;0;1;0;1
3554656;Unidade de Saúde Mental ;0;0;0;0;0
3554656;Unidade Móvel;0;0;0;0;0
3554656;Vigilância em Saúde;0;0;0;0;0
3554706;Clínica;0;0;0;0;0
3554706;Consultório Isolado;0;0;0;2;2
3554706;Diagnose e Terapia;0;0;0;1;1
3554706;Hospital;0;0;0;1;1
3554706;Outros;0;0;2;0;2
3554706;Pronto Atendimento;0;0;0;0;0
3554706;Unidade Básica de Saúde;0;0;2;0;2
3554706;Unidade de Saúde Mental ;0;0;1;0;1
3554706;Unidade Móvel;0;0;0;0;0
3554706;Vigilância em Saúde;0;0;0;0;0
3554755;Clínica;0;0;0;0;0
3554755;Consultório Isolado;0;0;0;0;0
3554755;Diagnose e Terapia;0;0;0;0;0
3554755;Hospital;0;0;0;0;0
3554755;Outros;0;0;1;0;1
3554755;Pronto Atendimento;0;0;0;0;0
3554755;Unidade Básica de Saúde;0;0;1;0;1
3554755;Unidade de Saúde Mental ;0;0;0;0;0
3554755;Unidade Móvel;0;0;0;0;0
3554755;Vigilância em Saúde;0;0;0;0;0
3554805;Clínica;0;0;1;17;18
3554805;Consultório Isolado;0;0;0;16;16
3554805;Diagnose e Terapia;0;0;1;2;3
3554805;Hospital;0;0;0;1;1
3554805;Outros;0;0;3;0;3
3554805;Pronto Atendimento;0;0;1;0;1
3554805;Unidade Básica de Saúde;5;0;8;0;13
3554805;Unidade de Saúde Mental ;0;0;0;0;0
3554805;Unidade Móvel;0;0;1;0;1
3554805;Vigilância em Saúde;0;0;1;0;1
3554904;Clínica;0;0;1;0;1
3554904;Consultório Isolado;0;0;0;0;0
3554904;Diagnose e Terapia;0;0;0;0;0
3554904;Hospital;0;0;0;0;0
3554904;Outros;0;0;1;0;1
3554904;Pronto Atendimento;0;0;0;0;0
3554904;Unidade Básica de Saúde;0;0;2;0;2
3554904;Unidade de Saúde Mental ;0;0;0;0;0
3554904;Unidade Móvel;0;0;0;0;0
3554904;Vigilância em Saúde;0;0;0;0;0
3554953;Clínica;0;0;1;0;1
3554953;Consultório Isolado;0;0;0;1;1
3554953;Diagnose e Terapia;0;0;0;1;1
3554953;Hospital;0;0;0;0;0
3554953;Outros;0;0;2;0;2
3554953;Pronto Atendimento;0;0;0;0;0
3554953;Unidade Básica de Saúde;0;0;1;0;1
3554953;Unidade de Saúde Mental ;0;0;0;0;0
3554953;Unidade Móvel;0;0;1;0;1
3554953;Vigilância em Saúde;0;0;0;0;0
3555000;Clínica;1;0;7;24;32
3555000;Consultório Isolado;0;0;0;191;191
3555000;Diagnose e Terapia;0;0;1;14;15
3555000;Hospital;0;0;0;5;5
3555000;Outros;1;0;8;2;11
3555000;Pronto Atendimento;0;0;1;0;1
3555000;Unidade Básica de Saúde;0;0;15;0;15
3555000;Unidade de Saúde Mental ;0;0;1;0;1
3555000;Unidade Móvel;0;0;0;0;0
3555000;Vigilância em Saúde;0;0;1;0;1
3555109;Clínica;0;0;1;1;2
3555109;Consultório Isolado;0;0;0;43;43
3555109;Diagnose e Terapia;0;0;0;3;3
3555109;Hospital;0;0;0;1;1
3555109;Outros;0;0;2;0;2
3555109;Pronto Atendimento;0;0;1;0;1
3555109;Unidade Básica de Saúde;2;0;5;0;7
3555109;Unidade de Saúde Mental ;0;0;0;0;0
3555109;Unidade Móvel;0;0;0;0;0
3555109;Vigilância em Saúde;0;0;1;0;1
3555208;Clínica;0;0;0;0;0
3555208;Consultório Isolado;0;0;0;0;0
3555208;Diagnose e Terapia;0;0;0;0;0
3555208;Hospital;0;0;0;0;0
3555208;Outros;0;0;1;0;1
3555208;Pronto Atendimento;0;0;0;0;0
3555208;Unidade Básica de Saúde;0;0;2;0;2
3555208;Unidade de Saúde Mental ;0;0;0;0;0
3555208;Unidade Móvel;0;0;0;0;0
3555208;Vigilância em Saúde;0;0;0;0;0
3555307;Clínica;0;0;0;0;0
3555307;Consultório Isolado;0;0;0;0;0
3555307;Diagnose e Terapia;0;0;1;0;1
3555307;Hospital;0;0;0;0;0
3555307;Outros;0;0;1;0;1
3555307;Pronto Atendimento;0;0;0;0;0
3555307;Unidade Básica de Saúde;0;0;2;0;2
3555307;Unidade de Saúde Mental ;0;0;0;0;0
3555307;Unidade Móvel;0;0;0;0;0
3555307;Vigilância em Saúde;0;0;0;0;0
3555356;Clínica;0;0;0;0;0
3555356;Consultório Isolado;0;0;0;0;0
3555356;Diagnose e Terapia;0;0;0;1;1
3555356;Hospital;0;0;0;0;0
3555356;Outros;0;0;1;0;1
3555356;Pronto Atendimento;0;0;0;0;0
3555356;Unidade Básica de Saúde;0;0;1;0;1
3555356;Unidade de Saúde Mental ;0;0;0;0;0
3555356;Unidade Móvel;0;0;0;0;0
3555356;Vigilância em Saúde;0;0;0;0;0
3555406;Clínica;0;0;4;4;8
3555406;Consultório Isolado;0;0;0;33;33
3555406;Diagnose e Terapia;0;0;0;7;7
3555406;Hospital;0;0;1;2;3
3555406;Outros;0;1;2;1;4
3555406;Pronto Atendimento;0;0;0;0;0
3555406;Unidade Básica de Saúde;0;0;27;0;27
3555406;Unidade de Saúde Mental ;0;0;1;0;1
3555406;Unidade Móvel;0;0;4;0;4
3555406;Vigilância em Saúde;0;0;1;0;1
3555505;Clínica;0;0;0;0;0
3555505;Consultório Isolado;0;0;0;1;1
3555505;Diagnose e Terapia;0;0;1;0;1
3555505;Hospital;0;0;0;0;0
3555505;Outros;0;0;5;0;5
3555505;Pronto Atendimento;0;0;0;0;0
3555505;Unidade Básica de Saúde;0;0;3;0;3
3555505;Unidade de Saúde Mental ;0;0;0;0;0
3555505;Unidade Móvel;0;0;0;0;0
3555505;Vigilância em Saúde;0;0;0;0;0
3555604;Clínica;0;0;0;2;2
3555604;Consultório Isolado;0;0;0;23;23
3555604;Diagnose e Terapia;0;0;0;2;2
3555604;Hospital;0;0;0;0;0
3555604;Outros;0;0;3;0;3
3555604;Pronto Atendimento;0;0;0;0;0
3555604;Unidade Básica de Saúde;0;0;3;0;3
3555604;Unidade de Saúde Mental ;0;0;1;0;1
3555604;Unidade Móvel;0;0;0;0;0
3555604;Vigilância em Saúde;0;0;0;0;0
3555703;Clínica;0;0;0;0;0
3555703;Consultório Isolado;0;0;0;0;0
3555703;Diagnose e Terapia;0;0;0;0;0
3555703;Hospital;0;0;0;0;0
3555703;Outros;0;0;3;0;3
3555703;Pronto Atendimento;0;0;0;0;0
3555703;Unidade Básica de Saúde;0;0;1;0;1
3555703;Unidade de Saúde Mental ;0;0;0;0;0
3555703;Unidade Móvel;0;0;0;0;0
3555703;Vigilância em Saúde;0;0;1;0;1
3555802;Clínica;0;0;2;1;3
3555802;Consultório Isolado;0;0;0;0;0
3555802;Diagnose e Terapia;0;0;0;1;1
3555802;Hospital;0;0;0;1;1
3555802;Outros;0;0;1;0;1
3555802;Pronto Atendimento;0;0;0;0;0
3555802;Unidade Básica de Saúde;0;0;3;0;3
3555802;Unidade de Saúde Mental ;0;0;0;0;0
3555802;Unidade Móvel;0;0;1;0;1
3555802;Vigilância em Saúde;0;0;0;0;0
3555901;Clínica;0;0;0;0;0
3555901;Consultório Isolado;0;0;0;0;0
3555901;Diagnose e Terapia;0;0;0;0;0
3555901;Hospital;0;0;0;0;0
3555901;Outros;0;0;2;0;2
3555901;Pronto Atendimento;0;0;0;0;0
3555901;Unidade Básica de Saúde;0;0;1;0;1
3555901;Unidade de Saúde Mental ;0;0;0;0;0
3555901;Unidade Móvel;0;0;0;0;0
3555901;Vigilância em Saúde;0;0;0;0;0
3556008;Clínica;0;0;1;4;5
3556008;Consultório Isolado;0;0;0;15;15
3556008;Diagnose e Terapia;0;0;0;2;2
3556008;Hospital;0;0;0;1;1
3556008;Outros;0;0;2;1;3
3556008;Pronto Atendimento;0;0;0;0;0
3556008;Unidade Básica de Saúde;0;0;5;0;5
3556008;Unidade de Saúde Mental ;0;0;0;0;0
3556008;Unidade Móvel;0;0;1;0;1
3556008;Vigilância em Saúde;0;0;0;0;0
3556107;Clínica;0;0;0;1;1
3556107;Consultório Isolado;0;0;0;14;14
3556107;Diagnose e Terapia;0;0;0;3;3
3556107;Hospital;0;0;0;0;0
3556107;Outros;0;0;3;0;3
3556107;Pronto Atendimento;0;0;0;0;0
3556107;Unidade Básica de Saúde;0;0;8;0;8
3556107;Unidade de Saúde Mental ;0;0;0;0;0
3556107;Unidade Móvel;0;0;0;0;0
3556107;Vigilância em Saúde;0;0;1;0;1
3556206;Clínica;0;0;10;56;66
3556206;Consultório Isolado;0;0;1;359;360
3556206;Diagnose e Terapia;0;0;1;17;18
3556206;Hospital;0;0;0;2;2
3556206;Outros;0;0;5;2;7
3556206;Pronto Atendimento;0;0;3;0;3
3556206;Unidade Básica de Saúde;0;0;15;0;15
3556206;Unidade de Saúde Mental ;0;0;4;0;4
3556206;Unidade Móvel;0;0;1;0;1
3556206;Vigilância em Saúde;0;0;1;0;1
3556305;Clínica;0;0;2;3;5
3556305;Consultório Isolado;0;0;0;26;26
3556305;Diagnose e Terapia;0;0;0;1;1
3556305;Hospital;0;0;0;1;1
3556305;Outros;0;0;2;0;2
3556305;Pronto Atendimento;0;0;0;0;0
3556305;Unidade Básica de Saúde;2;0;6;0;8
3556305;Unidade de Saúde Mental ;0;0;1;0;1
3556305;Unidade Móvel;0;0;0;0;0
3556305;Vigilância em Saúde;0;0;0;0;0
3556354;Clínica;0;0;0;1;1
3556354;Consultório Isolado;0;0;0;0;0
3556354;Diagnose e Terapia;0;0;0;0;0
3556354;Hospital;0;0;0;0;0
3556354;Outros;0;0;1;0;1
3556354;Pronto Atendimento;0;0;0;0;0
3556354;Unidade Básica de Saúde;0;0;3;0;3
3556354;Unidade de Saúde Mental ;0;0;0;0;0
3556354;Unidade Móvel;0;0;1;0;1
3556354;Vigilância em Saúde;0;0;0;0;0
3556404;Clínica;0;0;3;10;13
3556404;Consultório Isolado;0;0;0;96;96
3556404;Diagnose e Terapia;0;0;0;5;5
3556404;Hospital;0;0;0;1;1
3556404;Outros;0;0;2;0;2
3556404;Pronto Atendimento;0;0;1;0;1
3556404;Unidade Básica de Saúde;0;0;12;0;12
3556404;Unidade de Saúde Mental ;0;0;1;0;1
3556404;Unidade Móvel;0;0;1;0;1
3556404;Vigilância em Saúde;0;0;0;0;0
3556453;Clínica;0;0;4;19;23
3556453;Consultório Isolado;0;0;0;8;8
3556453;Diagnose e Terapia;0;0;0;1;1
3556453;Hospital;0;0;0;0;0
3556453;Outros;0;0;3;5;8
3556453;Pronto Atendimento;0;0;1;0;1
3556453;Unidade Básica de Saúde;0;0;9;0;9
3556453;Unidade de Saúde Mental ;0;0;1;0;1
3556453;Unidade Móvel;0;0;1;0;1
3556453;Vigilância em Saúde;0;0;2;0;2
3556503;Clínica;0;0;5;12;17
3556503;Consultório Isolado;0;0;0;13;13
3556503;Diagnose e Terapia;0;0;0;8;8
3556503;Hospital;0;0;1;1;2
3556503;Outros;0;0;3;1;4
3556503;Pronto Atendimento;0;0;1;0;1
3556503;Unidade Básica de Saúde;0;0;14;0;14
3556503;Unidade de Saúde Mental ;0;0;2;0;2
3556503;Unidade Móvel;0;0;1;0;1
3556503;Vigilância em Saúde;0;0;1;0;1
3556602;Clínica;0;0;0;4;4
3556602;Consultório Isolado;0;0;1;13;14
3556602;Diagnose e Terapia;0;0;0;0;0
3556602;Hospital;0;0;0;0;0
3556602;Outros;0;0;1;0;1
3556602;Pronto Atendimento;0;0;1;0;1
3556602;Unidade Básica de Saúde;0;0;3;0;3
3556602;Unidade de Saúde Mental ;0;0;0;0;0
3556602;Unidade Móvel;0;0;0;0;0
3556602;Vigilância em Saúde;0;0;0;0;0
3556701;Clínica;0;0;5;38;43
3556701;Consultório Isolado;0;0;1;299;300
3556701;Diagnose e Terapia;0;0;0;22;22
3556701;Hospital;0;0;0;1;1
3556701;Outros;0;0;2;1;3
3556701;Pronto Atendimento;0;0;2;0;2
3556701;Unidade Básica de Saúde;0;0;9;0;9
3556701;Unidade de Saúde Mental ;0;0;1;0;1
3556701;Unidade Móvel;0;0;0;0;0
3556701;Vigilância em Saúde;0;0;1;0;1
3556800;Clínica;0;0;3;5;8
3556800;Consultório Isolado;0;0;0;22;22
3556800;Diagnose e Terapia;0;0;1;4;5
3556800;Hospital;0;0;0;1;1
3556800;Outros;0;0;5;2;7
3556800;Pronto Atendimento;0;0;1;0;1
3556800;Unidade Básica de Saúde;0;0;5;0;5
3556800;Unidade de Saúde Mental ;0;0;0;0;0
3556800;Unidade Móvel;0;0;0;0;0
3556800;Vigilância em Saúde;0;0;0;0;0
3556909;Clínica;0;0;2;0;2
3556909;Consultório Isolado;0;0;0;3;3
3556909;Diagnose e Terapia;0;0;0;1;1
3556909;Hospital;0;0;0;0;0
3556909;Outros;0;0;1;0;1
3556909;Pronto Atendimento;0;0;0;0;0
3556909;Unidade Básica de Saúde;0;0;3;0;3
3556909;Unidade de Saúde Mental ;0;0;0;0;0
3556909;Unidade Móvel;0;0;0;0;0
3556909;Vigilância em Saúde;0;0;1;0;1
3556958;Clínica;0;0;1;0;1
3556958;Consultório Isolado;0;0;0;0;0
3556958;Diagnose e Terapia;0;0;0;0;0
3556958;Hospital;0;0;0;0;0
3556958;Outros;0;0;1;0;1
3556958;Pronto Atendimento;0;0;0;0;0
3556958;Unidade Básica de Saúde;0;0;1;0;1
3556958;Unidade de Saúde Mental ;0;0;0;0;0
3556958;Unidade Móvel;0;0;0;0;0
3556958;Vigilância em Saúde;0;0;0;0;0
3557006;Clínica;0;0;5;12;17
3557006;Consultório Isolado;0;0;1;88;89
3557006;Diagnose e Terapia;0;0;3;21;24
3557006;Hospital;0;0;1;2;3
3557006;Outros;0;0;6;1;7
3557006;Pronto Atendimento;0;0;1;0;1
3557006;Unidade Básica de Saúde;1;0;17;0;18
3557006;Unidade de Saúde Mental ;0;0;3;0;3
3557006;Unidade Móvel;0;0;2;2;4
3557006;Vigilância em Saúde;0;0;2;0;2
3557105;Clínica;1;0;5;100;106
3557105;Consultório Isolado;0;0;1;322;323
3557105;Diagnose e Terapia;0;0;2;31;33
3557105;Hospital;0;0;1;3;4
3557105;Outros;1;0;6;3;10
3557105;Pronto Atendimento;0;0;2;0;2
3557105;Unidade Básica de Saúde;0;0;18;0;18
3557105;Unidade de Saúde Mental ;0;0;2;0;2
3557105;Unidade Móvel;0;0;7;1;8
3557105;Vigilância em Saúde;0;0;1;0;1
3557154;Clínica;0;0;0;0;0
3557154;Consultório Isolado;0;0;0;0;0
3557154;Diagnose e Terapia;0;0;0;0;0
3557154;Hospital;0;0;0;0;0
3557154;Outros;0;0;2;0;2
3557154;Pronto Atendimento;0;0;0;0;0
3557154;Unidade Básica de Saúde;0;0;1;0;1
3557154;Unidade de Saúde Mental ;0;0;0;0;0
3557154;Unidade Móvel;0;0;0;0;0
3557154;Vigilância em Saúde;0;0;0;0;0
3557204;Clínica;0;0;0;1;1
3557204;Consultório Isolado;0;0;0;12;12
3557204;Diagnose e Terapia;0;0;0;2;2
3557204;Hospital;0;0;0;1;1
3557204;Outros;0;0;1;0;1
3557204;Pronto Atendimento;0;0;0;0;0
3557204;Unidade Básica de Saúde;0;0;4;0;4
3557204;Unidade de Saúde Mental ;0;0;1;0;1
3557204;Unidade Móvel;0;0;0;0;0
3557204;Vigilância em Saúde;0;0;0;0;0
3557303;Clínica;0;0;1;2;3
3557303;Consultório Isolado;0;0;0;3;3
3557303;Diagnose e Terapia;0;0;0;4;4
3557303;Hospital;0;0;0;0;0
3557303;Outros;0;0;1;0;1
3557303;Pronto Atendimento;0;0;1;0;1
3557303;Unidade Básica de Saúde;0;0;5;0;5
3557303;Unidade de Saúde Mental ;0;0;0;0;0
3557303;Unidade Móvel;0;0;1;0;1
3557303;Vigilância em Saúde;0;0;0;0;0
